"district","state","location_name","dist_code_2011","vill_code_2011","tot_p","tot_m","tot_f","p_lit","m_lit","f_lit","tot_work_p","tot_work_m","tot_work_f","adi_2011","msw_2011","asset_2011","fc_2011","bf_2011","adi_2019","msw_2019","asset_2019","fc_2019","bf_2019"
"jamui","bihar","Mahna","238.0","258579.0",1564,816,748,899,539,360,608,376,232,"6","2","1","2","1","7.0","2.0","2.0","2.0","1.0"
"jamui","bihar","Ganesh Nawada","238.0","258722.0",502,270,232,308,177,131,167,135,32,"7","2","2","2","1","9.0","2.0","2.0","2.0","3.0"
"jamui","bihar","Mahgain","238.0","258724.0",812,433,379,423,248,175,407,249,158,"6","2","1","2","1","7.0","2.0","2.0","2.0","1.0"
"jamui","bihar","Chhitma","238.0","258725.0",208,109,99,44,40,4,97,52,45,"6","2","1","2","1","7.0","2.0","2.0","2.0","1.0"
"jamui","bihar","Achari","238.0","258726.0",872,455,417,432,261,171,389,242,147,"6","2","1","2","1","7.0","2.0","2.0","2.0","1.0"
"jamui","bihar","Arsar","238.0","258728.0",7635,3955,3680,4329,2485,1844,1956,1694,262,"8","2","2","2","2","7.0","2.0","2.0","2.0","1.0"
"jamui","bihar","Ikaria","238.0","258730.0",1243,654,589,712,459,253,362,267,95,"6","2","1","2","1","7.0","2.0","2.0","2.0","1.0"
"jamui","bihar","Padmawat","238.0","258731.0",2568,1322,1246,1225,855,370,897,662,235,"7","2","2","2","1","7.0","2.0","2.0","2.0","1.0"
"jamui","bihar","Amin","238.0","258732.0",2422,1319,1103,1510,887,623,786,631,155,"6","2","1","2","1","7.0","2.0","2.0","2.0","1.0"
"jamui","bihar","Chordiha","238.0","258733.0",2173,1154,1019,1005,671,334,752,586,166,"7","2","2","2","1","7.0","2.0","2.0","2.0","1.0"
"jamui","bihar","Dundu","238.0","258734.0",1851,939,912,1101,635,466,458,405,53,"6","1","2","2","1","7.0","2.0","2.0","2.0","1.0"
"jamui","bihar","Narbada","238.0","258735.0",946,521,425,373,255,118,406,241,165,"6","1","2","2","1","7.0","2.0","2.0","2.0","1.0"
"jamui","bihar","Pira","238.0","258736.0",912,447,465,366,224,142,450,241,209,"5","1","1","2","1","7.0","2.0","2.0","2.0","1.0"
"jamui","bihar","Tola Bhorbhandari","238.0","258739.0",45,26,19,12,8,4,28,15,13,"9","2","2","2","3","6.0","2.0","2.0","1.0","1.0"
"jamui","bihar","Tola Gurmha","238.0","258742.0",702,375,327,302,185,117,336,178,158,"4","1","1","1","1","5.0","1.0","2.0","1.0","1.0"
"jamui","bihar","Bahera","238.0","258753.0",3737,1968,1769,1774,1162,612,1292,970,322,"4","1","1","1","1","6.0","1.0","2.0","2.0","1.0"
"jamui","bihar","Bishunpur","238.0","258757.0",3963,1979,1984,1663,1049,614,1628,939,689,"4","1","1","1","1","5.0","1.0","2.0","1.0","1.0"
"jamui","bihar","Kolhua","238.0","258761.0",5729,2946,2783,2514,1550,964,2564,1584,980,"7","2","1","3","1","7.0","2.0","2.0","2.0","1.0"
"jamui","bihar","Bhaluka","238.0","258763.0",3178,1634,1544,1069,748,321,1440,820,620,"6","1","1","3","1","7.0","2.0","2.0","2.0","1.0"
"jamui","bihar","Bariarpur","238.0","258764.0",3502,1799,1703,1388,886,502,1449,873,576,"6","1","1","3","1","7.0","2.0","2.0","2.0","1.0"
"jamui","bihar","Mohanpur","238.0","258765.0",249,125,124,97,65,32,99,69,30,"4","1","1","1","1","6.0","1.0","2.0","2.0","1.0"
"jamui","bihar","Patauna","238.0","258766.0",2291,1204,1087,1258,770,488,1228,683,545,"6","1","1","3","1","7.0","2.0","2.0","2.0","1.0"
"jamui","bihar","Narsota","238.0","258767.0",412,220,192,244,136,108,113,102,11,"10","2","3","2","3","7.0","2.0","2.0","2.0","1.0"
"jamui","bihar","Achhra","238.0","258768.0",1100,586,514,741,423,318,564,296,268,"8","2","2","3","1","6.0","2.0","2.0","1.0","1.0"
"jamui","bihar","Phulwaria","238.0","258769.0",1378,696,682,681,409,272,723,359,364,"8","2","2","3","1","7.0","2.0","2.0","2.0","1.0"
"jamui","bihar","Nasrichak","238.0","258770.0",471,253,218,246,150,96,140,97,43,"6","1","2","2","1","7.0","2.0","2.0","2.0","1.0"
"jamui","bihar","Katauna","238.0","258771.0",8358,4374,3984,4919,2943,1976,3770,2235,1535,"7","2","2","2","1","7.0","2.0","2.0","2.0","1.0"
"jamui","bihar","Sukhlewa","238.0","258772.0",836,435,401,475,276,199,376,195,181,"6","2","1","2","1","9.0","2.0","2.0","2.0","3.0"
"jamui","bihar","Darha","238.0","258774.0",6476,3374,3102,2991,1886,1105,2733,1678,1055,"8","2","2","3","1","7.0","2.0","2.0","2.0","1.0"
"jamui","bihar","Labhet","238.0","258776.0",1518,827,691,988,598,390,322,232,90,"5","1","2","1","1","7.0","2.0","2.0","2.0","1.0"
"jamui","bihar","Bhandara","238.0","258777.0",2633,1393,1240,1246,827,419,998,619,379,"7","1","2","3","1","7.0","2.0","2.0","2.0","1.0"
"jamui","bihar","Lakhai","238.0","258778.0",4215,2191,2024,2213,1354,859,1298,1024,274,"5","2","1","1","1","7.0","2.0","2.0","2.0","1.0"
"jamui","bihar","Panro","238.0","258779.0",5823,3059,2764,3064,1987,1077,2296,1516,780,"5","1","2","1","1","6.0","1.0","2.0","2.0","1.0"
"jamui","bihar","Chinmaria","238.0","258780.0",3880,2018,1862,1599,993,606,1682,1047,635,"6","1","1","3","1","7.0","2.0","2.0","2.0","1.0"
"jamui","bihar","Kakanchaur","238.0","258781.0",7310,3735,3575,2951,1847,1104,3406,1856,1550,"4","1","1","1","1","5.0","1.0","2.0","1.0","1.0"
"jamui","bihar","Karanpur","238.0","258783.0",4818,2540,2278,2424,1567,857,2085,1381,704,"7","1","2","3","1","7.0","2.0","2.0","2.0","1.0"
"jamui","bihar","Maraia","238.0","258784.0",5125,2637,2488,2326,1541,785,2595,1469,1126,"5","1","1","2","1","7.0","2.0","2.0","2.0","1.0"
"jamui","bihar","Naukadih","238.0","258785.0",1789,941,848,984,576,408,602,473,129,"7","1","2","3","1","7.0","2.0","2.0","2.0","1.0"
"jamui","bihar","Panot","238.0","258787.0",738,388,350,414,247,167,370,183,187,"7","1","2","3","1","5.0","1.0","2.0","1.0","1.0"
"jamui","bihar","Mednipur","238.0","258789.0",366,192,174,194,125,69,194,107,87,"8","2","2","3","1","6.0","1.0","2.0","2.0","1.0"
"jamui","bihar","Guria","238.0","258790.0",800,435,365,389,238,151,421,212,209,"7","1","2","3","1","7.0","2.0","2.0","2.0","1.0"
"jamui","bihar","Donha","238.0","258791.0",386,208,178,233,139,94,173,93,80,"6","2","2","1","1","6.0","1.0","2.0","2.0","1.0"
"jamui","bihar","Matia","238.0","258793.0",6074,3185,2889,3127,1951,1176,2513,1617,896,"5","1","2","1","1","6.0","2.0","2.0","1.0","1.0"
"jamui","bihar","Mohanpur","238.0","258794.0",2786,1401,1385,1300,771,529,1263,690,573,"5","1","2","1","1","5.0","1.0","1.0","2.0","1.0"
"jamui","bihar","Kenuhat","238.0","258795.0",1672,895,777,815,509,306,766,421,345,"4","1","1","1","1","6.0","1.0","2.0","2.0","1.0"
"jamui","bihar","Gordih","238.0","258797.0",1132,613,519,846,497,349,513,314,199,"5","1","2","1","1","5.0","1.0","2.0","1.0","1.0"
"jamui","bihar","Sakal","238.0","258798.0",2461,1253,1208,1248,760,488,1143,633,510,"5","1","2","1","1","6.0","2.0","1.0","2.0","1.0"
"jamui","bihar","Tengahra","238.0","258801.0",3586,1858,1728,1716,1001,715,1488,900,588,"4","1","1","1","1","5.0","1.0","2.0","1.0","1.0"
"jamui","bihar","Domachak","238.0","258802.0",1208,601,607,595,343,252,536,279,257,"5","1","2","1","1","5.0","1.0","2.0","1.0","1.0"
"jamui","bihar","Harla","238.0","258803.0",4155,2139,2016,2564,1513,1051,1738,1056,682,"5","1","2","1","1","5.0","1.0","2.0","1.0","1.0"
"jamui","bihar","Masle","238.0","258804.0",1082,567,515,501,298,203,527,267,260,"6","2","2","1","1","6.0","1.0","2.0","2.0","1.0"
"jamui","bihar","Kala","238.0","258805.0",3303,1751,1552,1709,1086,623,1454,744,710,"5","1","2","1","1","5.0","1.0","2.0","1.0","1.0"
"jamui","bihar","Jinhara","238.0","258810.0",1545,791,754,791,456,335,838,438,400,"6","2","2","1","1","6.0","1.0","2.0","2.0","1.0"
"jamui","bihar","Asota","238.0","258811.0",582,296,286,265,181,84,292,161,131,"8","2","2","3","1","5.0","1.0","2.0","1.0","1.0"
"jamui","bihar","Bishunpur","238.0","258812.0",1040,540,500,486,344,142,471,255,216,"5","1","2","1","1","6.0","1.0","2.0","2.0","1.0"
"jamui","bihar","Ojhadih","238.0","258813.0",739,399,340,493,280,213,367,182,185,"6","2","2","1","1","7.0","1.0","2.0","3.0","1.0"
"jamui","bihar","Harchak","238.0","258814.0",439,217,222,60,55,5,287,142,145,"4","1","1","1","1","5.0","2.0","1.0","1.0","1.0"
"jamui","bihar","Pindraun","238.0","258815.0",1919,1037,882,838,560,278,956,491,465,"5","1","2","1","1","6.0","1.0","2.0","2.0","1.0"
"jamui","bihar","Teliadih","238.0","258825.0",921,476,445,473,310,163,435,221,214,"5","1","2","1","1","5.0","1.0","2.0","1.0","1.0"
"jamui","bihar","Sabalpur","238.0","258826.0",718,385,333,432,263,169,390,205,185,"5","1","2","1","1","6.0","1.0","2.0","2.0","1.0"
"jamui","bihar","Pemadih","238.0","258827.0",313,167,146,175,115,60,150,79,71,"5","1","2","1","1","5.0","1.0","2.0","1.0","1.0"
"jamui","bihar","Tola Alagjara","238.0","258829.0",132,63,69,49,30,19,55,30,25,"4","1","1","1","1","6.0","2.0","2.0","1.0","1.0"
"jamui","bihar","Tola Sukhasan","238.0","258832.0",683,358,325,205,134,71,338,170,168,"5","2","1","1","1","5.0","1.0","2.0","1.0","1.0"
"jamui","bihar","Tola Kasba Dighi","238.0","258833.0",4064,2086,1978,2234,1324,910,1681,1013,668,"5","1","2","1","1","6.0","1.0","2.0","2.0","1.0"
"jamui","bihar","Tola Kamlu","238.0","258834.0",1269,651,618,353,230,123,500,316,184,"5","2","1","1","1","5.0","1.0","2.0","1.0","1.0"
"jamui","bihar","Mohanpur","238.0","258836.0",4621,2480,2141,2195,1437,758,2267,1280,987,"5","1","2","1","1","5.0","1.0","2.0","1.0","1.0"
"jamui","bihar","Tetaria","238.0","258839.0",223,119,104,82,48,34,114,59,55,"4","1","1","1","1","5.0","1.0","2.0","1.0","1.0"
"jamui","bihar","Tola Sundrotanr","238.0","258841.0",1167,616,551,550,327,223,602,318,284,"5","1","2","1","1","8.0","2.0","2.0","3.0","1.0"
"jamui","bihar","Tola Bela Tikur","238.0","258842.0",522,268,254,325,175,150,257,133,124,"5","2","1","1","1","5.0","1.0","2.0","1.0","1.0"
"jamui","bihar","Tola Khelar","238.0","258845.0",1646,862,784,942,551,391,1046,549,497,"5","1","2","1","1","8.0","2.0","2.0","3.0","1.0"
"jamui","bihar","Tola Jhonpa","238.0","258849.0",549,294,255,332,202,130,275,139,136,"5","1","2","1","1","5.0","1.0","2.0","1.0","1.0"
"jamui","bihar","Tola Karamtanr","238.0","258850.0",893,481,412,427,290,137,482,247,235,"6","1","2","2","1","6.0","1.0","2.0","2.0","1.0"
"jamui","bihar","Tola Pamna","238.0","258851.0",1543,827,716,901,575,326,803,434,369,"5","1","2","1","1","6.0","2.0","2.0","1.0","1.0"
"jamui","bihar","Tola Nawabandh","238.0","258852.0",281,154,127,143,95,48,136,81,55,"5","1","2","1","1","7.0","2.0","2.0","2.0","1.0"
"jamui","bihar","Tola Nawadih","238.0","258853.0",195,99,96,60,37,23,91,55,36,"5","2","1","1","1","6.0","1.0","2.0","2.0","1.0"
"jamui","bihar","Tola Gadi Mangrar","238.0","258858.0",6364,3322,3042,2966,1927,1039,3191,1809,1382,"5","1","2","1","1","6.0","1.0","2.0","2.0","1.0"
"jamui","bihar","Tola Purnadih","238.0","258859.0",766,394,372,293,203,90,424,214,210,"5","2","1","1","1","5.0","1.0","2.0","1.0","1.0"
"jamui","bihar","Tola Ghormara","238.0","258991.0",401,221,180,251,147,104,196,104,92,"6","1","1","3","1","6.0","2.0","2.0","1.0","1.0"
"jamui","bihar","Tola Ukharia","238.0","258992.0",264,132,132,67,41,26,116,60,56,"4","1","1","1","1","6.0","2.0","2.0","1.0","1.0"
"jamui","bihar","Tola Barakola","238.0","258993.0",181,93,88,60,35,25,91,61,30,"5","1","2","1","1","5.0","2.0","1.0","1.0","1.0"
"jamui","bihar","Tola Pachkathia","238.0","258995.0",192,100,92,73,50,23,110,54,56,"4","1","1","1","1","5.0","2.0","1.0","1.0","1.0"
"jamui","bihar","Tola Kansajharna","238.0","258997.0",65,37,28,0,0,0,30,18,12,"4","1","1","1","1","7.0","2.0","2.0","2.0","1.0"
"jamui","bihar","Tola Jinatbhandar","238.0","258999.0",82,38,44,29,14,15,39,20,19,"4","1","1","1","1","6.0","2.0","1.0","2.0","1.0"
"jamui","bihar","Tola Jurpania","238.0","259000.0",582,325,257,267,193,74,268,136,132,"4","1","1","1","1","5.0","1.0","1.0","2.0","1.0"
"jamui","bihar","Tola Thelpathal","238.0","259001.0",198,99,99,66,42,24,101,51,50,"4","1","1","1","1","7.0","2.0","2.0","2.0","1.0"
"jamui","bihar","Machhendra","238.0","259002.0",1619,834,785,891,505,386,666,349,317,"7","1","2","3","1","5.0","1.0","2.0","1.0","1.0"
"jamui","bihar","Dadpur","238.0","259004.0",1830,951,879,974,608,366,898,538,360,"6","2","2","1","1","7.0","2.0","2.0","2.0","1.0"
"jamui","bihar","Dhiba","238.0","259005.0",1776,935,841,788,543,245,782,449,333,"6","2","1","2","1","7.0","2.0","2.0","2.0","1.0"
"jamui","bihar","Ramdaspur","238.0","259007.0",1625,872,753,752,491,261,857,489,368,"6","2","2","1","1","7.0","2.0","2.0","2.0","1.0"
"jamui","bihar","Kharhaia Urf Jamu","238.0","259008.0",3622,1873,1749,1566,995,571,1567,904,663,"6","2","1","2","1","7.0","2.0","2.0","2.0","1.0"
"jamui","bihar","Sidhesri","238.0","259009.0",3933,2080,1853,2220,1418,802,1956,1043,913,"6","2","2","1","1","6.0","2.0","2.0","1.0","1.0"
"jamui","bihar","Hathia","238.0","259010.0",7411,3866,3545,2996,1980,1016,3597,1979,1618,"7","1","2","3","1","7.0","2.0","2.0","2.0","1.0"
"jamui","bihar","Tola Amakoli","238.0","259011.0",330,163,167,71,38,33,193,95,98,"6","2","2","1","1","6.0","2.0","2.0","1.0","1.0"
"jamui","bihar","Tola Dudharwa","238.0","259012.0",181,90,91,52,37,15,102,49,53,"4","1","1","1","1","7.0","3.0","2.0","1.0","1.0"
"jamui","bihar","Tola Hardia","238.0","259013.0",132,63,69,23,11,12,69,35,34,"6","1","1","1","3","5.0","2.0","1.0","1.0","1.0"
"jamui","bihar","Tola Dahua","238.0","259014.0",159,82,77,29,12,17,49,40,9,"4","1","1","1","1","7.0","2.0","2.0","2.0","1.0"
"jamui","bihar","Tola Ghorparan","238.0","259018.0",239,104,135,95,56,39,41,40,1,"5","1","2","1","1","6.0","2.0","2.0","1.0","1.0"
"jamui","bihar","Tola Patua","238.0","259019.0",159,79,80,22,9,13,48,37,11,"4","1","1","1","1","5.0","2.0","1.0","1.0","1.0"
"jamui","bihar","Tola Amjhari","238.0","259020.0",24,11,13,3,3,0,9,6,3,"4","1","1","1","1","5.0","1.0","2.0","1.0","1.0"
"jamui","bihar","Tola Kanaudi","238.0","259022.0",3383,1761,1622,1109,835,274,1299,822,477,"4","1","1","1","1","5.0","1.0","2.0","1.0","1.0"
"jamui","bihar","Tola Khurandadhorari","238.0","259023.0",2926,1519,1407,1066,751,315,1093,710,383,"5","1","2","1","1","5.0","1.0","2.0","1.0","1.0"
"jamui","bihar","Tola Khuranda","238.0","259024.0",2456,1298,1158,935,655,280,1033,621,412,"7","1","2","3","1","6.0","2.0","2.0","1.0","1.0"
"jamui","bihar","Tola Gopalmaran","238.0","259025.0",460,245,215,162,107,55,211,123,88,"4","1","1","1","1","6.0","2.0","2.0","1.0","1.0"
"jamui","bihar","Tola Bangawan","238.0","259026.0",757,402,355,333,195,138,274,212,62,"4","1","1","1","1","8.0","2.0","2.0","3.0","1.0"
"jamui","bihar","Tola Lilabaran","238.0","259027.0",877,450,427,361,270,91,273,210,63,"5","1","2","1","1","6.0","2.0","2.0","1.0","1.0"
"jamui","bihar","Tola Tithi  Chak","238.0","259029.0",357,186,171,92,61,31,102,101,1,"4","1","1","1","1","6.0","2.0","2.0","1.0","1.0"
"jamui","bihar","Tola Tilauna","238.0","259030.0",563,295,268,217,147,70,278,153,125,"4","1","1","1","1","5.0","1.0","2.0","1.0","1.0"
"jamui","bihar","Tola Bastiyadih","238.0","259031.0",395,198,197,202,127,75,121,77,44,"6","2","2","1","1","5.0","1.0","2.0","1.0","1.0"
"jamui","bihar","Tola Bathnabaran","238.0","259033.0",1429,702,727,450,305,145,369,346,23,"5","2","1","1","1","7.0","2.0","2.0","2.0","1.0"
"jamui","bihar","Tola Ghontari","238.0","259034.0",311,157,154,85,44,41,167,87,80,"4","1","1","1","1","7.0","1.0","2.0","3.0","1.0"
"jamui","bihar","Tola Damgitar","238.0","259036.0",429,232,197,40,32,8,129,128,1,"4","1","1","1","1","5.0","1.0","2.0","1.0","1.0"
"jamui","bihar","Tola Nagwe","238.0","259037.0",1989,1040,949,890,630,260,856,501,355,"5","1","2","1","1","5.0","1.0","2.0","1.0","1.0"
"jamui","bihar","Tola Godaia","238.0","259039.0",1695,878,817,900,600,300,761,437,324,"5","1","2","1","1","5.0","1.0","2.0","1.0","1.0"
"jamui","bihar","Tola Pandua","238.0","259040.0",52,24,28,24,15,9,8,8,0,"5","1","2","1","1","5.0","1.0","2.0","1.0","1.0"
"jamui","bihar","Tola Siantanr","238.0","259042.0",1660,869,791,784,508,276,619,374,245,"5","1","2","1","1","8.0","2.0","2.0","3.0","1.0"
"jamui","bihar","Tola Pararia","238.0","259045.0",514,264,250,152,99,53,254,152,102,"7","1","2","3","1","7.0","1.0","2.0","3.0","1.0"
"jamui","bihar","Tola Telwabazar","238.0","259046.0",2441,1267,1174,1745,999,746,724,644,80,"9","1","2","3","3","5.0","1.0","2.0","1.0","1.0"
"jamui","bihar","Tola Dhonrari","238.0","259050.0",715,398,317,319,217,102,193,191,2,"5","1","2","1","1","5.0","1.0","2.0","1.0","1.0"
"jamui","bihar","Tola Chiraiya","238.0","259051.0",1601,842,759,838,517,321,558,400,158,"5","1","2","1","1","5.0","1.0","2.0","1.0","1.0"
"jamui","bihar","Tola Gadi Telwa","238.0","259052.0",1702,890,812,815,535,280,644,429,215,"7","1","2","3","1","5.0","1.0","2.0","1.0","1.0"
"jamui","bihar","Tola Telwa","238.0","259054.0",567,290,277,183,106,77,187,144,43,"4","1","1","1","1","5.0","1.0","2.0","1.0","1.0"
"jamui","bihar","Tola Burhiabari","238.0","259055.0",668,345,323,279,186,93,180,172,8,"5","1","1","2","1","6.0","1.0","2.0","2.0","1.0"
"jamui","bihar","Tola Pathal Chapti","238.0","259056.0",518,285,233,256,163,93,143,131,12,"4","1","1","1","1","5.0","1.0","2.0","1.0","1.0"
"jamui","bihar","Maura","238.0","259059.0",7163,3753,3410,3225,2139,1086,3114,1785,1329,"6","1","1","3","1","6.0","2.0","2.0","1.0","1.0"
"jamui","bihar","Gangra","238.0","259060.0",7680,4051,3629,3332,2106,1226,3017,1874,1143,"7","2","1","3","1","7.0","2.0","2.0","2.0","1.0"
"jamui","bihar","Sansarpur","238.0","259061.0",1060,558,502,342,229,113,393,284,109,"6","2","2","1","1","6.0","2.0","2.0","1.0","1.0"
"jamui","bihar","Banjhulia","238.0","259063.0",939,485,454,570,352,218,435,237,198,"5","2","1","1","1","7.0","2.0","2.0","2.0","1.0"
"jamui","bihar","Bandhaura","238.0","259065.0",1832,998,834,926,634,292,831,511,320,"6","1","2","2","1","6.0","2.0","1.0","2.0","1.0"
"jamui","bihar","Dhobghat","238.0","259067.0",2756,1510,1246,1589,980,609,1185,762,423,"7","2","2","2","1","7.0","2.0","2.0","2.0","1.0"
"jamui","bihar","Simaria","238.0","259068.0",617,329,288,302,178,124,298,199,99,"7","2","2","2","1","7.0","2.0","2.0","2.0","1.0"
"jamui","bihar","Kolhua","238.0","259069.0",2930,1543,1387,1633,1033,600,914,709,205,"7","2","2","2","1","6.0","1.0","2.0","2.0","1.0"
"jamui","bihar","Kumardih","238.0","259070.0",1471,755,716,907,523,384,612,394,218,"7","2","2","2","1","5.0","1.0","2.0","1.0","1.0"
"jamui","bihar","Mahuli","238.0","259072.0",2961,1547,1414,1547,972,575,1452,846,606,"6","2","1","2","1","6.0","1.0","2.0","2.0","1.0"
"jamui","bihar","Sewa","238.0","259073.0",9151,4888,4263,4995,3186,1809,3700,2267,1433,"6","2","2","1","1","7.0","2.0","2.0","2.0","1.0"
"jamui","bihar","Ratanpur","238.0","259074.0",10968,5687,5281,6215,3782,2433,3935,2741,1194,"7","2","2","2","1","7.0","2.0","2.0","2.0","1.0"
"jamui","bihar","Kundhur","238.0","259075.0",3519,1812,1707,1763,1037,726,1551,935,616,"7","2","2","2","1","7.0","2.0","2.0","2.0","1.0"
"jamui","bihar","Nayagaon","238.0","259076.0",1268,689,579,691,457,234,321,310,11,"7","2","2","2","1","7.0","2.0","2.0","2.0","1.0"
"jamui","bihar","Genadih","238.0","259077.0",2813,1464,1349,1626,977,649,1075,687,388,"7","2","2","2","1","7.0","2.0","2.0","2.0","1.0"
"jamui","bihar","Singarpur","238.0","259080.0",2331,1243,1088,1143,693,450,741,608,133,"7","2","2","2","1","6.0","2.0","2.0","1.0","1.0"
"jamui","bihar","Ballopur","238.0","259081.0",1490,761,729,630,407,223,396,375,21,"8","2","2","3","1","5.0","1.0","2.0","1.0","1.0"
"jamui","bihar","Naudiha","238.0","259082.0",2281,1205,1076,1457,816,641,768,563,205,"8","2","2","3","1","6.0","2.0","2.0","1.0","1.0"
"jamui","bihar","Amari","238.0","259085.0",3370,1767,1603,1703,1114,589,1341,854,487,"8","2","2","3","1","6.0","2.0","2.0","1.0","1.0"
"jamui","bihar","Khutauna","238.0","259086.0",1342,721,621,871,545,326,660,356,304,"5","1","2","1","1","7.0","2.0","2.0","2.0","1.0"
"jamui","bihar","Dharampur","238.0","259087.0",1792,935,857,957,571,386,676,466,210,"7","1","2","3","1","7.0","2.0","2.0","2.0","1.0"
"jamui","bihar","Kharui","238.0","259089.0",1441,740,701,723,433,290,310,299,11,"5","1","2","1","1","7.0","2.0","2.0","2.0","1.0"
"jamui","bihar","Dumarkola","238.0","259090.0",3775,2024,1751,1931,1168,763,1521,1014,507,"5","1","2","1","1","8.0","2.0","2.0","3.0","1.0"
"jamui","bihar","Kashmir","238.0","259091.0",2997,1560,1437,1124,754,370,857,761,96,"4","1","1","1","1","6.0","2.0","2.0","1.0","1.0"
"jamui","bihar","Kasbagidhaur","238.0","259092.0",212,104,108,27,18,9,55,55,0,"5","2","1","1","1","6.0","2.0","2.0","1.0","1.0"
"jamui","bihar","Ghanberia","238.0","259093.0",3625,1964,1661,2473,1423,1050,1404,994,410,"6","2","2","1","1","7.0","2.0","2.0","2.0","1.0"
"jamui","bihar","Khaira","238.0","259094.0",9581,5068,4513,5566,3383,2183,3530,2392,1138,"6","2","2","1","1","8.0","2.0","2.0","3.0","1.0"
"jamui","bihar","Gopalpur","238.0","259095.0",3651,1908,1743,2092,1209,883,1471,1007,464,"6","2","2","1","1","7.0","2.0","2.0","2.0","1.0"
"jamui","bihar","Raipura","238.0","259096.0",3105,1630,1475,2027,1149,878,1596,846,750,"10","2","2","3","3","7.0","2.0","2.0","2.0","1.0"
"jamui","bihar","Kendih","238.0","259098.0",3268,1744,1524,1873,1161,712,1219,921,298,"6","2","2","1","1","6.0","2.0","2.0","1.0","1.0"
"jamui","bihar","Parsa","238.0","259099.0",981,569,412,791,465,326,309,296,13,"7","2","2","2","1","7.0","2.0","2.0","2.0","1.0"
"jamui","bihar","Bhaunr","238.0","259100.0",3738,1975,1763,1966,1174,792,1474,911,563,"6","2","2","1","1","9.0","2.0","3.0","3.0","1.0"
"jamui","bihar","Pakri","238.0","259101.0",785,401,384,409,245,164,268,203,65,"8","2","2","3","1","7.0","2.0","2.0","2.0","1.0"
"jamui","bihar","Baribag Jaljoga","238.0","259102.0",2240,1146,1094,1009,627,382,738,583,155,"7","2","1","3","1","6.0","2.0","2.0","1.0","1.0"
"jamui","bihar","Fatehpur","238.0","259103.0",3605,1882,1723,1729,1041,688,1745,958,787,"6","2","2","1","1","7.0","1.0","2.0","3.0","1.0"
"jamui","bihar","Jorbaha Dharampur","238.0","259105.0",2074,1088,986,725,491,234,645,531,114,"5","1","2","1","1","7.0","2.0","2.0","2.0","1.0"
"jamui","bihar","Bhojpur","238.0","259107.0",867,444,423,388,250,138,565,310,255,"5","1","2","1","1","6.0","1.0","2.0","2.0","1.0"
"jamui","bihar","Daingarwaphulandih","238.0","259108.0",2212,1142,1070,938,630,308,820,485,335,"6","1","2","2","1","6.0","1.0","2.0","2.0","1.0"
"jamui","bihar","Tola Naukadih","238.0","259110.0",119,61,58,59,36,23,51,27,24,"6","2","2","1","1","7.0","2.0","2.0","2.0","1.0"
"jamui","bihar","Tola Chandar Seli","238.0","259113.0",1545,824,721,937,568,369,773,453,320,"5","1","2","1","1","7.0","1.0","2.0","3.0","1.0"
"jamui","bihar","Tola Bhalni","238.0","259120.0",558,277,281,278,164,114,318,157,161,"6","1","2","2","1","7.0","2.0","2.0","2.0","1.0"
"jamui","bihar","Tola Tetaria","238.0","259122.0",670,358,312,273,228,45,395,205,190,"6","2","2","1","1","5.0","1.0","2.0","1.0","1.0"
"jamui","bihar","Tola Amatari","238.0","259123.0",330,169,161,140,97,43,193,96,97,"4","1","1","1","1","8.0","2.0","2.0","3.0","1.0"
"jamui","bihar","Tola Raksa","238.0","259260.0",726,376,350,387,224,163,294,169,125,"5","1","2","1","1","6.0","1.0","2.0","2.0","1.0"
"jamui","bihar","Tola Mahgaon","238.0","259263.0",3656,1932,1724,1997,1272,725,1556,1009,547,"5","1","2","1","1","7.0","2.0","2.0","2.0","1.0"
"jamui","bihar","Tola Bijaia","238.0","259264.0",1608,824,784,548,381,167,657,391,266,"5","1","2","1","1","5.0","1.0","2.0","1.0","1.0"
"jamui","bihar","Tola Lewa","238.0","259265.0",508,256,252,213,153,60,298,145,153,"4","1","1","1","1","5.0","1.0","2.0","1.0","1.0"
"jamui","bihar","Tola Hirniatanr","238.0","259267.0",54,29,25,31,19,12,22,15,7,"6","2","2","1","1","6.0","2.0","2.0","1.0","1.0"
"jamui","bihar","Tola Karmatanr","238.0","259268.0",457,219,238,203,123,80,156,104,52,"4","1","1","1","1","5.0","1.0","2.0","1.0","1.0"
"jamui","bihar","Tola Morbaia","238.0","259269.0",244,126,118,45,29,16,131,68,63,"5","2","1","1","1","5.0","1.0","2.0","1.0","1.0"
"jamui","bihar","Tola Nonchhaha","238.0","259270.0",70,37,33,38,29,9,36,19,17,"5","1","2","1","1","5.0","1.0","2.0","1.0","1.0"
"jamui","bihar","Tola Arbaria","238.0","259272.0",649,325,324,310,190,120,271,135,136,"5","1","2","1","1","5.0","1.0","2.0","1.0","1.0"
"jamui","bihar","Tola Bujhanet","238.0","259273.0",1741,913,828,899,530,369,853,465,388,"5","1","2","1","1","6.0","1.0","1.0","3.0","1.0"
"jamui","bihar","Tola Jarwanari","238.0","259274.0",107,59,48,89,50,39,30,27,3,"5","1","2","1","1","5.0","1.0","2.0","1.0","1.0"
"jamui","bihar","Tola Naiadih","238.0","259278.0",1504,768,736,452,332,120,795,405,390,"4","1","1","1","1","5.0","1.0","2.0","1.0","1.0"
"jamui","bihar","Tola Panari","238.0","259283.0",419,217,202,166,106,60,221,111,110,"4","1","1","1","1","5.0","1.0","2.0","1.0","1.0"
"jamui","bihar","Tola Binjhi","238.0","259286.0",136,69,67,54,33,21,66,32,34,"4","1","1","1","1","5.0","1.0","2.0","1.0","1.0"
"jamui","bihar","Tola Kusaia","238.0","259287.0",935,484,451,360,282,78,434,217,217,"5","1","2","1","1","5.0","1.0","2.0","1.0","1.0"
"jamui","bihar","Tola Burhialapur","238.0","259288.0",1179,618,561,417,307,110,536,265,271,"4","1","1","1","1","6.0","2.0","2.0","1.0","1.0"
"jamui","bihar","Tola Chendara","238.0","259289.0",712,359,353,166,116,50,382,212,170,"4","1","1","1","1","5.0","2.0","1.0","1.0","1.0"
"jamui","bihar","Tola Thakurkura","238.0","259291.0",86,47,39,54,36,18,21,17,4,"4","1","1","1","1","6.0","2.0","2.0","1.0","1.0"
"jamui","bihar","Tola Kewali","238.0","259295.0",1764,909,855,1002,562,440,677,442,235,"6","2","1","2","1","7.0","2.0","2.0","2.0","1.0"
"jamui","bihar","Tola Balkakna","238.0","259297.0",149,80,69,104,65,39,106,65,41,"6","2","2","1","1","6.0","2.0","2.0","1.0","1.0"
"jamui","bihar","Tola Balthar","238.0","259298.0",1876,965,911,1176,696,480,668,427,241,"7","1","2","3","1","7.0","2.0","2.0","2.0","1.0"
"jamui","bihar","Tola Sono","238.0","259302.0",9932,5321,4611,6311,3790,2521,3110,2400,710,"10","2","2","3","3","7.0","2.0","2.0","2.0","1.0"
"jamui","bihar","Tola Debipahari","238.0","259303.0",53,24,29,34,14,20,20,13,7,"7","2","3","1","1","7.0","2.0","2.0","2.0","1.0"
"jamui","bihar","Dokli","238.0","259305.0",2668,1290,1378,1313,775,538,1111,589,522,"8","2","2","3","1","6.0","2.0","2.0","1.0","1.0"
"jamui","bihar","Churhit","238.0","259306.0",2777,1394,1383,1449,846,603,880,673,207,"6","2","2","1","1","7.0","2.0","2.0","2.0","1.0"
"jamui","bihar","Shaharpharka","238.0","259307.0",2074,1106,968,1036,665,371,860,550,310,"8","2","2","3","1","7.0","2.0","2.0","2.0","1.0"
"jamui","bihar","Keshopharka","238.0","259308.0",3900,2025,1875,1897,1183,714,2136,1102,1034,"7","2","1","3","1","6.0","2.0","1.0","2.0","1.0"
"jamui","bihar","Kanhaipharka","238.0","259310.0",526,283,243,343,218,125,188,120,68,"7","2","2","2","1","7.0","2.0","2.0","2.0","1.0"
"jamui","bihar","Tola Ghutwe","238.0","259311.0",2051,1053,998,861,591,270,1081,557,524,"4","1","1","1","1","5.0","1.0","2.0","1.0","1.0"
"jamui","bihar","Tola Bautha","238.0","259312.0",3150,1626,1524,1174,824,350,1640,844,796,"4","1","1","1","1","7.0","1.0","2.0","3.0","1.0"
"jamui","bihar","Tola Sabaijor","238.0","259313.0",2276,1206,1070,1147,727,420,797,575,222,"7","1","2","3","1","6.0","2.0","2.0","1.0","1.0"
"jamui","bihar","Tola Sarebad","238.0","259314.0",4794,2527,2267,2218,1429,789,1897,1211,686,"5","1","1","2","1","6.0","2.0","2.0","1.0","1.0"
"jamui","bihar","Tola Agahara","238.0","259316.0",3770,1956,1814,1675,1121,554,1553,945,608,"7","1","2","3","1","7.0","2.0","2.0","2.0","1.0"
"jamui","bihar","Tola Dehurkhi","238.0","259317.0",631,324,307,251,169,82,329,165,164,"5","1","1","2","1","7.0","2.0","2.0","2.0","1.0"
"jamui","bihar","Tola Asahana","238.0","259318.0",868,439,429,509,291,218,409,206,203,"4","1","1","1","1","7.0","2.0","2.0","2.0","1.0"
"jamui","bihar","Tola DubedihBabudih","238.0","259323.0",5398,2754,2644,2360,1483,877,2577,1376,1201,"6","1","1","3","1","6.0","2.0","2.0","1.0","1.0"
"jamui","bihar","Tola Chapri","238.0","259325.0",1049,553,496,418,302,116,427,285,142,"6","1","2","2","1","6.0","1.0","2.0","2.0","1.0"
"jamui","bihar","Tola Bhelwa Mohanpur","238.0","259328.0",1382,722,660,601,371,230,765,392,373,"7","1","2","3","1","6.0","1.0","2.0","2.0","1.0"
"jamui","bihar","Tola Karhara Chaupal","238.0","259329.0",597,267,330,219,137,82,307,134,173,"6","1","1","1","3","5.0","1.0","2.0","1.0","1.0"
"jamui","bihar","Tola Kamatcheraiya  Simar","238.0","259331.0",165,83,82,49,35,14,80,41,39,"6","2","1","2","1","5.0","1.0","2.0","1.0","1.0"
"jamui","bihar","Tola Kamat","238.0","259332.0",264,136,128,108,76,32,106,58,48,"5","1","2","1","1","5.0","1.0","2.0","1.0","1.0"
"jamui","bihar","Tola Taraun","238.0","259334.0",654,328,326,278,189,89,301,152,149,"6","1","2","2","1","7.0","1.0","2.0","3.0","1.0"
"jamui","bihar","Tola Dudhkasoi","238.0","259335.0",643,324,319,228,161,67,169,169,0,"5","1","1","2","1","6.0","2.0","2.0","1.0","1.0"
"jamui","bihar","Tola Ghosari","238.0","259336.0",156,81,75,50,36,14,37,35,2,"5","1","1","2","1","6.0","1.0","2.0","2.0","1.0"
"jamui","bihar","Tola Charghara  Kohila","238.0","259337.0",1379,711,668,385,257,128,623,397,226,"6","1","2","2","1","7.0","2.0","2.0","2.0","1.0"
"jamui","bihar","Tola Chhuchhundaria","238.0","259338.0",2658,1372,1286,534,384,150,1181,695,486,"4","1","1","1","1","5.0","1.0","2.0","1.0","1.0"
"jamui","bihar","Tola Sarkanda","238.0","259339.0",1996,1012,984,785,537,248,816,489,327,"4","1","1","1","1","5.0","1.0","2.0","1.0","1.0"
"jamui","bihar","Tola Chhatakaram","238.0","259340.0",550,289,261,131,118,13,302,153,149,"5","1","2","1","1","5.0","1.0","2.0","1.0","1.0"
"jamui","bihar","Tola Belakura","238.0","259341.0",181,94,87,35,28,7,100,53,47,"5","1","2","1","1","5.0","1.0","2.0","1.0","1.0"
"jamui","bihar","Tola Bhagwana","238.0","259342.0",1843,930,913,713,513,200,750,477,273,"6","1","1","3","1","5.0","1.0","2.0","1.0","1.0"
"jamui","bihar","Tola Dumro Sukro","238.0","259343.0",2017,1079,938,892,591,301,970,493,477,"4","1","1","1","1","5.0","1.0","2.0","1.0","1.0"
"jamui","bihar","Tola Tarbank","238.0","259344.0",1030,523,507,298,204,94,335,267,68,"4","1","1","1","1","5.0","1.0","2.0","1.0","1.0"
"jamui","bihar","Tola Radhiachhop","238.0","259345.0",512,253,259,131,76,55,205,114,91,"5","2","1","1","1","5.0","1.0","2.0","1.0","1.0"
"jamui","bihar","Tola Charka Pathar","238.0","259346.0",1613,870,743,726,491,235,864,448,416,"5","1","2","1","1","6.0","2.0","2.0","1.0","1.0"
"jamui","bihar","Tola Lalilewar","238.0","259347.0",2418,1225,1193,759,540,219,1245,670,575,"6","1","1","3","1","5.0","1.0","2.0","1.0","1.0"
"jamui","bihar","Tola Kairi","238.0","259348.0",571,290,281,141,83,58,122,120,2,"7","3","2","1","1","6.0","2.0","2.0","1.0","1.0"
"jamui","bihar","Tola Purainia","238.0","259351.0",158,77,81,10,8,2,81,42,39,"4","1","1","1","1","5.0","1.0","2.0","1.0","1.0"
"jamui","bihar","Tola Sonailtanr","238.0","259352.0",621,317,304,209,130,79,288,147,141,"4","1","1","1","1","6.0","2.0","2.0","1.0","1.0"
"jamui","bihar","Tola Mahesri Gadi","238.0","259353.0",4384,2432,1952,2373,1548,825,1853,1257,596,"7","1","2","3","1","8.0","2.0","2.0","3.0","1.0"
"jamui","bihar","Tola Tilakpur","238.0","259354.0",896,466,430,326,203,123,468,226,242,"6","1","2","2","1","6.0","1.0","2.0","2.0","1.0"
"jamui","bihar","Tola Boghakewal","238.0","259355.0",931,466,465,350,224,126,387,244,143,"8","2","2","3","1","5.0","1.0","2.0","1.0","1.0"
"jamui","bihar","Tola Nainipathar","238.0","259360.0",1106,558,548,561,310,251,440,286,154,"4","1","1","1","1","5.0","1.0","2.0","1.0","1.0"
"jamui","bihar","Tola Takar","238.0","259362.0",2462,1231,1231,600,393,207,1267,581,686,"4","1","1","1","1","5.0","1.0","2.0","1.0","1.0"
"jamui","bihar","Tola Garhtanr","238.0","259363.0",1215,635,580,231,155,76,554,312,242,"4","1","1","1","1","5.0","1.0","2.0","1.0","1.0"
"jamui","bihar","Tola Thamhan","238.0","259364.0",1822,937,885,621,396,225,868,439,429,"4","1","1","1","1","6.0","2.0","2.0","1.0","1.0"
"jamui","bihar","Tola Chilkakhas","238.0","259365.0",558,274,284,216,124,92,358,181,177,"4","1","1","1","1","5.0","1.0","2.0","1.0","1.0"
"jamui","bihar","Tola Barmoria","238.0","259366.0",83,47,36,35,29,6,52,31,21,"6","2","2","1","1","5.0","1.0","2.0","1.0","1.0"
"jamui","bihar","Tola Asarkho","238.0","259368.0",267,120,147,60,33,27,115,53,62,"5","2","1","1","1","5.0","1.0","2.0","1.0","1.0"
"jamui","bihar","Tola Makarkend","238.0","259369.0",990,533,457,114,86,28,459,250,209,"4","1","1","1","1","6.0","2.0","2.0","1.0","1.0"
"jamui","bihar","Tola Kaunia","238.0","259372.0",1705,882,823,690,476,214,725,415,310,"6","2","2","1","1","4.0","1.0","1.0","1.0","1.0"
"jamui","bihar","Tola Berbari","238.0","259373.0",27,16,11,5,4,1,12,12,0,"5","1","1","2","1","6.0","1.0","2.0","2.0","1.0"
"jamui","bihar","Tola Dhamni","238.0","259374.0",758,366,392,204,153,51,442,202,240,"4","1","1","1","1","4.0","1.0","1.0","1.0","1.0"
"jamui","bihar","Tola Paharpur","238.0","259375.0",232,120,112,19,16,3,75,58,17,"4","1","1","1","1","7.0","1.0","2.0","3.0","1.0"
"jamui","bihar","Tola Barad Pichra","238.0","259376.0",177,91,86,10,9,1,54,42,12,"4","1","1","1","1","5.0","1.0","2.0","1.0","1.0"
"jamui","bihar","Tola Sonailtanr","238.0","259377.0",404,204,200,192,126,66,187,93,94,"4","1","1","1","1","7.0","1.0","2.0","3.0","1.0"
"jamui","bihar","Tola Kharik","238.0","259381.0",870,419,451,384,220,164,468,228,240,"7","1","2","3","1","5.0","1.0","2.0","1.0","1.0"
"jamui","bihar","Tola Karmatanr","238.0","259382.0",131,73,58,49,41,8,63,32,31,"4","1","1","1","1","4.0","1.0","1.0","1.0","1.0"
"jamui","bihar","Tola Sugatanr","238.0","259383.0",143,77,66,53,34,19,42,39,3,"6","1","2","2","1","8.0","2.0","2.0","3.0","1.0"
"jamui","bihar","Tola Painkandh","238.0","259385.0",334,184,150,156,105,51,84,81,3,"4","1","1","1","1","5.0","1.0","2.0","1.0","1.0"
"jamui","bihar","Tola Bhalua","238.0","259386.0",586,319,267,249,170,79,255,136,119,"6","2","1","2","1","5.0","1.0","2.0","1.0","1.0"
"jamui","bihar","Tola Kadwa","238.0","259390.0",202,106,96,50,35,15,97,54,43,"4","1","1","1","1","5.0","1.0","2.0","1.0","1.0"
"jamui","bihar","Tola Bhelsumbhia","238.0","259391.0",1970,1034,936,827,558,269,889,460,429,"4","1","1","1","1","6.0","2.0","2.0","1.0","1.0"
"jamui","bihar","Tola Urwa","238.0","259525.0",1378,735,643,825,493,332,452,356,96,"7","1","2","3","1","5.0","1.0","2.0","1.0","1.0"
"jamui","bihar","Tola Jalkharia","238.0","259526.0",708,385,323,339,226,113,262,180,82,"5","1","2","1","1","5.0","1.0","2.0","1.0","1.0"
"jamui","bihar","Tola Maharajdih","238.0","259528.0",1210,603,607,484,304,180,346,263,83,"7","1","2","3","1","5.0","1.0","2.0","1.0","1.0"
"jamui","bihar","Tola Jamuni","238.0","259529.0",1197,633,564,608,400,208,620,327,293,"6","1","2","2","1","5.0","1.0","2.0","1.0","1.0"
"jamui","bihar","Tola Lakhandih","238.0","259530.0",16,10,6,11,9,2,7,3,4,"6","1","3","1","1","5.0","1.0","2.0","1.0","1.0"
"jamui","bihar","Tola Garbhudih","238.0","259531.0",305,159,146,134,84,50,153,74,79,"4","1","1","1","1","5.0","1.0","2.0","1.0","1.0"
"jamui","bihar","Tola Narodih","238.0","259532.0",1237,663,574,730,464,266,399,364,35,"5","1","2","1","1","5.0","1.0","2.0","1.0","1.0"
"jamui","bihar","Tola Motedih","238.0","259533.0",250,113,137,57,38,19,121,57,64,"7","1","2","3","1","5.0","1.0","2.0","1.0","1.0"
"jamui","bihar","Tola Goriadih","238.0","259534.0",277,150,127,130,82,48,142,79,63,"7","1","2","3","1","5.0","1.0","2.0","1.0","1.0"
"jamui","bihar","Tola Patjori","238.0","259535.0",1113,574,539,645,439,206,502,331,171,"7","1","2","3","1","5.0","1.0","2.0","1.0","1.0"
"jamui","bihar","Tola Pipra","238.0","259536.0",336,179,157,202,127,75,103,77,26,"5","1","2","1","1","5.0","1.0","2.0","1.0","1.0"
"jamui","bihar","Tola Gadhara","238.0","259537.0",375,190,185,284,166,118,127,101,26,"5","1","2","1","1","5.0","1.0","2.0","1.0","1.0"
"jamui","bihar","Tola Bagho","238.0","259538.0",147,77,70,88,59,29,53,51,2,"5","1","1","2","1","5.0","1.0","2.0","1.0","1.0"
"jamui","bihar","Tola Muralipahari","238.0","259539.0",16,11,5,11,9,2,8,4,4,"5","1","2","1","1","5.0","1.0","2.0","1.0","1.0"
"jamui","bihar","Tola Gajhi","238.0","259540.0",740,393,347,419,269,150,367,187,180,"6","1","2","2","1","5.0","1.0","2.0","1.0","1.0"
"jamui","bihar","Tola Kaknia","238.0","259541.0",103,53,50,54,35,19,57,31,26,"8","2","2","3","1","5.0","1.0","2.0","1.0","1.0"
"jamui","bihar","Tola Binjha","238.0","259545.0",625,317,308,264,176,88,290,148,142,"4","1","1","1","1","5.0","1.0","2.0","1.0","1.0"
"jamui","bihar","Tola Rangnia","238.0","259548.0",501,284,217,215,159,56,448,249,199,"4","1","1","1","1","5.0","1.0","2.0","1.0","1.0"
"jamui","bihar","Tola Bichkorwa","238.0","259549.0",567,302,265,416,232,184,266,136,130,"6","1","1","3","1","5.0","1.0","2.0","1.0","1.0"
"jamui","bihar","Tola Jamua","238.0","259550.0",455,231,224,116,82,34,300,162,138,"5","1","1","2","1","5.0","1.0","2.0","1.0","1.0"
"jamui","bihar","Tola Sanghara","238.0","259551.0",409,218,191,222,160,62,392,210,182,"6","1","2","2","1","7.0","1.0","2.0","3.0","1.0"
"jamui","bihar","Tola Baratanr","238.0","259552.0",139,75,64,42,35,7,43,22,21,"5","1","2","1","1","6.0","1.0","2.0","2.0","1.0"
"jamui","bihar","Tola Bichgarha","238.0","259554.0",134,71,63,52,40,12,61,31,30,"6","2","2","1","1","7.0","1.0","2.0","3.0","1.0"
"jamui","bihar","Tola Durgadikh","238.0","259555.0",427,224,203,183,133,50,153,109,44,"6","2","1","2","1","5.0","1.0","2.0","1.0","1.0"
"jamui","bihar","Tola Nauadih","238.0","259556.0",753,403,350,440,240,200,200,183,17,"6","1","2","2","1","5.0","1.0","2.0","1.0","1.0"
"jamui","bihar","Tola Barkitanr","238.0","259557.0",50,25,25,26,14,12,25,12,13,"7","1","3","2","1","5.0","1.0","2.0","1.0","1.0"
"jamui","bihar","Tola Hirnatanr","238.0","259558.0",608,323,285,242,162,80,310,162,148,"6","1","2","2","1","6.0","1.0","2.0","2.0","1.0"
"jamui","bihar","Tola Murwadih","238.0","259559.0",185,93,92,65,45,20,87,43,44,"6","2","1","2","1","5.0","1.0","2.0","1.0","1.0"
"jamui","bihar","Tola Mankitari","238.0","259560.0",222,114,108,44,26,18,104,57,47,"6","2","1","2","1","6.0","1.0","2.0","2.0","1.0"
"jamui","bihar","Tola Dulaia","238.0","259561.0",194,100,94,15,11,4,95,48,47,"6","2","1","2","1","5.0","1.0","2.0","1.0","1.0"
"jamui","bihar","Tola Ghurnawa","238.0","259562.0",145,75,70,55,40,15,96,47,49,"5","1","2","1","1","5.0","1.0","2.0","1.0","1.0"
"jamui","bihar","Tola Katiawa","238.0","259563.0",568,317,251,226,178,48,412,229,183,"4","1","1","1","1","5.0","1.0","2.0","1.0","1.0"
"jamui","bihar","Tola Mahjori","238.0","259564.0",5,2,3,0,0,0,4,2,2,"4","1","1","1","1","6.0","1.0","2.0","2.0","1.0"
"jamui","bihar","Tola Jiudaha","238.0","259565.0",23,15,8,9,9,0,19,12,7,"5","1","2","1","1","7.0","2.0","1.0","3.0","1.0"
"jamui","bihar","Tola Asalbania","238.0","259566.0",41,25,16,28,21,7,21,11,10,"5","1","2","1","1","6.0","1.0","2.0","2.0","1.0"
"jamui","bihar","Tola Bhalua","238.0","259570.0",186,90,96,44,37,7,95,48,47,"4","1","1","1","1","5.0","1.0","2.0","1.0","1.0"
"jamui","bihar","Tola Panna","238.0","259571.0",57,31,26,40,26,14,27,13,14,"4","1","1","1","1","5.0","1.0","2.0","1.0","1.0"
"jamui","bihar","Tola Naiadih","238.0","259572.0",159,93,66,72,56,16,88,46,42,"4","1","1","1","1","6.0","1.0","2.0","2.0","1.0"
"jamui","bihar","Tola Baksila","238.0","259574.0",949,510,439,423,283,140,491,266,225,"5","1","2","1","1","5.0","1.0","2.0","1.0","1.0"
"jamui","bihar","Tola Kolharia","238.0","259575.0",144,76,68,41,30,11,84,47,37,"4","1","1","1","1","5.0","1.0","2.0","1.0","1.0"
"jamui","bihar","Tola Jamua","238.0","259576.0",356,176,180,134,82,52,170,81,89,"4","1","1","1","1","5.0","1.0","2.0","1.0","1.0"
"jamui","bihar","Tola Mahamdia","238.0","259577.0",510,263,247,231,139,92,277,143,134,"5","1","2","1","1","5.0","1.0","2.0","1.0","1.0"
"jamui","bihar","Tola Nakta","238.0","259579.0",538,289,249,187,128,59,321,176,145,"6","2","2","1","1","5.0","1.0","2.0","1.0","1.0"
"jamui","bihar","Tola Bhajusar","238.0","259580.0",169,85,84,1,1,0,126,67,59,"5","1","1","2","1","5.0","1.0","2.0","1.0","1.0"
"jamui","bihar","Tola Charka","238.0","259581.0",498,256,242,217,134,83,351,180,171,"6","1","2","2","1","5.0","1.0","2.0","1.0","1.0"
"jamui","bihar","Tola Harin Singha","238.0","259582.0",493,266,227,39,26,13,269,136,133,"5","1","2","1","1","5.0","1.0","2.0","1.0","1.0"
"jamui","bihar","Tola Basatpur","238.0","259585.0",483,252,231,262,192,70,205,147,58,"5","1","1","2","1","6.0","1.0","2.0","2.0","1.0"
"jamui","bihar","Tola Jhumarbad","238.0","259587.0",369,197,172,189,145,44,287,152,135,"4","1","1","1","1","6.0","1.0","2.0","2.0","1.0"
"jamui","bihar","Tola karhi","238.0","259589.0",426,215,211,298,171,127,213,119,94,"6","1","2","2","1","6.0","1.0","2.0","2.0","1.0"
"jamui","bihar","Tola Leruwa","238.0","259590.0",188,89,99,105,56,49,106,53,53,"5","1","1","2","1","7.0","1.0","2.0","3.0","1.0"
"jamui","bihar","Tola Kotha","238.0","259591.0",147,76,71,82,48,34,66,39,27,"6","1","2","2","1","5.0","1.0","2.0","1.0","1.0"
"jamui","bihar","Tola Amarwa","238.0","259592.0",53,32,21,25,16,9,36,21,15,"5","1","1","2","1","5.0","1.0","2.0","1.0","1.0"
"jamui","bihar","Tola Lakhua","238.0","259593.0",127,65,62,75,42,33,69,35,34,"6","1","2","2","1","5.0","1.0","2.0","1.0","1.0"
"jamui","bihar","Tola Ghutiari","238.0","259595.0",566,312,254,293,230,63,374,217,157,"6","1","2","2","1","7.0","1.0","2.0","3.0","1.0"
"jamui","bihar","Tola Gobindpur","238.0","259600.0",507,258,249,231,145,86,297,157,140,"4","1","1","1","1","5.0","1.0","2.0","1.0","1.0"
"jamui","bihar","Tola Fatehpur","238.0","259602.0",244,131,113,145,93,52,110,64,46,"7","1","2","3","1","5.0","1.0","2.0","1.0","1.0"
"jamui","bihar","Tola Partappur","238.0","259603.0",492,265,227,261,181,80,281,142,139,"5","1","2","1","1","7.0","1.0","2.0","3.0","1.0"
"jamui","bihar","Tola Kusamha","238.0","259606.0",235,119,116,65,45,20,99,55,44,"4","1","1","1","1","5.0","1.0","2.0","1.0","1.0"
"jamui","bihar","Tola Dhanwe","238.0","259610.0",342,184,158,165,114,51,243,122,121,"5","1","2","1","1","5.0","1.0","2.0","1.0","1.0"
"jamui","bihar","Tola Bhalua","238.0","259611.0",29,18,11,16,14,2,19,12,7,"5","1","2","1","1","5.0","1.0","2.0","1.0","1.0"
"jamui","bihar","Tola Karmatanr","238.0","259612.0",162,86,76,53,37,16,94,51,43,"4","1","1","1","1","5.0","1.0","2.0","1.0","1.0"
"jamui","bihar","Tola Mohanpur","238.0","259614.0",13,5,8,4,3,1,4,2,2,"4","1","1","1","1","5.0","1.0","2.0","1.0","1.0"
"jamui","bihar","Tola Dulampur","238.0","259616.0",2010,1092,918,701,510,191,963,653,310,"5","1","2","1","1","5.0","1.0","2.0","1.0","1.0"
"jamui","bihar","Tola Dhaturia","238.0","259619.0",170,79,91,64,41,23,38,36,2,"4","1","1","1","1","5.0","1.0","2.0","1.0","1.0"
"jamui","bihar","Tola Sarasbadia","238.0","259622.0",239,127,112,43,34,9,189,99,90,"5","1","2","1","1","4.0","1.0","1.0","1.0","1.0"
"jamui","bihar","Tola Khokhlu","238.0","259624.0",125,60,65,25,21,4,97,51,46,"5","1","2","1","1","5.0","1.0","2.0","1.0","1.0"
"jamui","bihar","Tola Chitardih","238.0","259625.0",559,292,267,250,158,92,275,140,135,"5","1","2","1","1","5.0","1.0","2.0","1.0","1.0"
"jamui","bihar","Tola Badgunda","238.0","259626.0",688,369,319,239,167,72,202,156,46,"4","1","1","1","1","5.0","1.0","2.0","1.0","1.0"
"jamui","bihar","Tola Hariharpur","238.0","259628.0",267,140,127,159,94,65,195,105,90,"4","1","1","1","1","6.0","2.0","2.0","1.0","1.0"
"jamui","bihar","Tola Lakra","238.0","259629.0",180,92,88,112,65,47,139,72,67,"4","1","1","1","1","5.0","1.0","2.0","1.0","1.0"
"jamui","bihar","Tola Khutmo","238.0","259630.0",70,36,34,40,27,13,62,34,28,"4","1","1","1","1","5.0","1.0","2.0","1.0","1.0"
"jamui","bihar","Tola Uparsapaha","238.0","259631.0",351,176,175,134,88,46,162,91,71,"4","1","1","1","1","5.0","1.0","2.0","1.0","1.0"
"jamui","bihar","Tola Dotna","238.0","259632.0",294,152,142,87,56,31,169,87,82,"4","1","1","1","1","5.0","1.0","2.0","1.0","1.0"
"jamui","bihar","Tola Sijhua","238.0","259633.0",126,74,52,74,55,19,64,37,27,"4","1","1","1","1","5.0","1.0","2.0","1.0","1.0"
"jamui","bihar","Tola Bisodah","238.0","259634.0",822,465,357,394,265,129,262,217,45,"4","1","1","1","1","5.0","1.0","2.0","1.0","1.0"
"jamui","bihar","Tola Gobardaha","238.0","259638.0",202,108,94,124,76,48,153,81,72,"5","2","1","1","1","7.0","1.0","2.0","3.0","1.0"
"jamui","bihar","Tola Hethsapaha","238.0","259639.0",101,56,45,76,42,34,80,43,37,"4","1","1","1","1","5.0","1.0","2.0","1.0","1.0"
"jamui","bihar","Tola Khori","238.0","259640.0",309,153,156,204,104,100,225,113,112,"4","1","1","1","1","6.0","1.0","1.0","3.0","1.0"
"jamui","bihar","Tola Bhalua","238.0","259641.0",437,228,209,343,179,164,218,110,108,"4","1","1","1","1","5.0","1.0","2.0","1.0","1.0"
"jamui","bihar","Tola Karijhal","238.0","259643.0",356,193,163,133,93,40,170,101,69,"4","1","1","1","1","5.0","1.0","2.0","1.0","1.0"
"jamui","bihar","Tola Baghopatar","238.0","259645.0",709,343,366,327,205,122,554,272,282,"4","1","1","1","1","5.0","1.0","2.0","1.0","1.0"
"jamui","bihar","Tola Lohsinghna","238.0","259646.0",1567,802,765,758,470,288,818,412,406,"4","1","1","1","1","5.0","1.0","2.0","1.0","1.0"
"jamui","bihar","Tola Khendubanwa","238.0","259647.0",259,136,123,145,111,34,72,64,8,"4","1","1","1","1","7.0","1.0","2.0","3.0","1.0"
"jamui","bihar","Tola Semra","238.0","259648.0",649,331,318,365,237,128,268,165,103,"4","1","1","1","1","6.0","1.0","2.0","2.0","1.0"
"jamui","bihar","Tola Salaia","238.0","259649.0",316,149,167,150,106,44,97,77,20,"5","1","2","1","1","5.0","1.0","2.0","1.0","1.0"
"jamui","bihar","Tola Ganaiya","238.0","259650.0",971,483,488,393,268,125,485,256,229,"4","1","1","1","1","6.0","1.0","2.0","2.0","1.0"
"jamui","bihar","Tola Rajasarai","238.0","259651.0",250,136,114,93,62,31,188,98,90,"4","1","1","1","1","6.0","1.0","2.0","2.0","1.0"
"jamui","bihar","Tola Murli","238.0","259652.0",264,137,127,109,79,30,203,108,95,"4","1","1","1","1","5.0","1.0","2.0","1.0","1.0"
"jamui","bihar","Tola Basmania","238.0","259653.0",571,315,256,312,198,114,513,281,232,"4","1","1","1","1","5.0","1.0","2.0","1.0","1.0"
"jamui","bihar","Tola Tetaria","238.0","259655.0",589,318,271,226,147,79,318,160,158,"4","1","1","1","1","5.0","1.0","2.0","1.0","1.0"
"jamui","bihar","Tola Kholhatanr","238.0","259656.0",75,44,31,37,27,10,21,18,3,"4","1","1","1","1","5.0","1.0","2.0","1.0","1.0"
"jamui","bihar","Tola Banpokhar","238.0","259658.0",658,333,325,329,219,110,430,218,212,"4","1","1","1","1","5.0","1.0","2.0","1.0","1.0"
"jamui","bihar","Tola karangarh","238.0","259659.0",1698,937,761,1133,725,408,620,459,161,"5","1","2","1","1","5.0","1.0","2.0","1.0","1.0"
"jamui","bihar","Tola Tinchua","238.0","259794.0",552,296,256,228,153,75,293,163,130,"6","1","1","3","1","5.0","1.0","2.0","1.0","1.0"
"jamui","bihar","Tola Chihra","238.0","259795.0",381,188,193,190,116,74,213,102,111,"5","1","2","1","1","5.0","1.0","2.0","1.0","1.0"
"jamui","bihar","Tola Balkar","238.0","259796.0",304,161,143,146,91,55,170,97,73,"5","1","2","1","1","5.0","1.0","2.0","1.0","1.0"
"jamui","bihar","Tola Satbhaia","238.0","259797.0",336,176,160,16,13,3,177,133,44,"7","1","2","3","1","5.0","1.0","2.0","1.0","1.0"
"jamui","bihar","Tola Korhia","238.0","259798.0",236,125,111,29,19,10,99,83,16,"7","1","2","3","1","4.0","1.0","1.0","1.0","1.0"
"jamui","bihar","Tola Dhabauna","238.0","259799.0",411,202,209,221,142,79,118,104,14,"4","1","1","1","1","5.0","1.0","2.0","1.0","1.0"
"jamui","bihar","Tola Jhausa","238.0","259800.0",140,76,64,51,37,14,48,42,6,"4","1","1","1","1","5.0","1.0","2.0","1.0","1.0"
"jamui","bihar","Tola Basbutia","238.0","259802.0",698,368,330,202,143,59,265,169,96,"6","1","1","3","1","6.0","1.0","2.0","2.0","1.0"
"jamui","bihar","Tola Majhli","238.0","259803.0",71,44,27,30,18,12,39,20,19,"5","1","1","2","1","7.0","1.0","2.0","3.0","1.0"
"jamui","bihar","Tola Bela","238.0","259808.0",185,97,88,97,60,37,85,47,38,"6","1","2","2","1","5.0","1.0","2.0","1.0","1.0"
"jamui","bihar","Tola Lodhma","238.0","259810.0",188,105,83,83,55,28,76,47,29,"6","1","2","2","1","6.0","1.0","2.0","2.0","1.0"
"jamui","bihar","Tola Bishunpur","238.0","259813.0",634,325,309,247,157,90,328,174,154,"5","1","1","2","1","6.0","1.0","2.0","2.0","1.0"
"jamui","bihar","Tola Sirsia","238.0","259814.0",462,234,228,173,127,46,258,129,129,"5","1","1","2","1","5.0","1.0","2.0","1.0","1.0"
"jamui","bihar","Tola Manikpur","238.0","259815.0",478,251,227,226,134,92,165,115,50,"6","1","2","2","1","5.0","1.0","2.0","1.0","1.0"
"jamui","bihar","Tola Majhligangti","238.0","259816.0",130,69,61,45,32,13,46,35,11,"6","1","2","2","1","6.0","1.0","2.0","2.0","1.0"
"jamui","bihar","Tola Chandarmandih","238.0","259817.0",518,268,250,229,161,68,269,142,127,"5","1","1","2","1","6.0","1.0","2.0","2.0","1.0"
"jamui","bihar","Tola Gadi","238.0","259825.0",936,507,429,483,336,147,365,281,84,"6","1","2","2","1","7.0","2.0","2.0","2.0","1.0"
"jamui","bihar","Tola Chorhata","238.0","259826.0",537,269,268,231,135,96,176,134,42,"5","1","1","2","1","5.0","1.0","2.0","1.0","1.0"
"jamui","bihar","Tola lakhmidih","238.0","259830.0",358,172,186,174,98,76,194,95,99,"5","1","1","2","1","5.0","1.0","2.0","1.0","1.0"
"jamui","bihar","Tola Gauridih","238.0","259832.0",391,196,195,236,135,101,193,93,100,"5","1","1","2","1","6.0","1.0","2.0","2.0","1.0"
"jamui","bihar","Tola Dhamania","238.0","259833.0",909,489,420,491,307,184,278,244,34,"6","1","2","2","1","6.0","1.0","2.0","2.0","1.0"
"jamui","bihar","Tola Bara","238.0","259837.0",587,302,285,141,101,40,211,160,51,"6","1","2","2","1","7.0","1.0","2.0","3.0","1.0"
"jamui","bihar","Tola Gharbhasan","238.0","259841.0",351,175,176,172,101,71,94,85,9,"7","3","1","2","1","6.0","1.0","2.0","2.0","1.0"
"jamui","bihar","Tola Kishunjor","238.0","259844.0",415,210,205,183,127,56,190,120,70,"7","1","2","3","1","6.0","1.0","2.0","2.0","1.0"
"jamui","bihar","Tola Jagadih","238.0","259846.0",494,262,232,195,141,54,301,172,129,"7","1","2","3","1","7.0","1.0","2.0","3.0","1.0"
"jamui","bihar","Tola Methitanr","238.0","259848.0",86,43,43,49,31,18,45,25,20,"7","2","1","3","1","7.0","1.0","2.0","3.0","1.0"
"jamui","bihar","Jaruwadih","238.0","259853.0",768,410,358,562,331,231,201,189,12,"5","1","1","2","1","7.0","1.0","2.0","3.0","1.0"
"jamui","bihar","Akhane","238.0","259858.0",730,401,329,270,189,81,272,220,52,"4","1","1","1","1","6.0","1.0","2.0","2.0","1.0"
"jamui","bihar","Tola Nawada","238.0","259859.0",1305,648,657,560,359,201,632,346,286,"5","1","2","1","1","5.0","1.0","2.0","1.0","1.0"
"jamui","bihar","Tola Dhamatanr","238.0","259861.0",1556,814,742,715,474,241,757,402,355,"4","1","1","1","1","7.0","1.0","2.0","3.0","1.0"
"jamui","bihar","Tola Chandarmandih","238.0","259862.0",2322,1182,1140,1016,697,319,1021,614,407,"5","1","2","1","1","7.0","2.0","2.0","2.0","1.0"
"jamui","bihar","Tola Sagdanidih","238.0","259863.0",815,423,392,348,231,117,323,200,123,"6","1","1","3","1","5.0","1.0","2.0","1.0","1.0"
"jamui","bihar","Asnaha","238.0","259865.0",1171,634,537,634,431,203,488,324,164,"4","1","1","1","1","7.0","1.0","2.0","3.0","1.0"
"jamui","bihar","Tola Korane","238.0","259866.0",1296,661,635,705,417,288,366,308,58,"7","1","2","3","1","5.0","1.0","2.0","1.0","1.0"
"jamui","bihar","Tola Hirnatanr","238.0","259867.0",656,372,284,197,139,58,202,187,15,"5","1","2","1","1","5.0","1.0","2.0","1.0","1.0"
"jamui","bihar","Tola Jogidih","238.0","259868.0",812,420,392,420,258,162,209,201,8,"5","1","2","1","1","5.0","1.0","2.0","1.0","1.0"
"jamui","bihar","Tola Pipra","238.0","259869.0",272,136,136,163,99,64,117,71,46,"5","1","2","1","1","6.0","2.0","2.0","1.0","1.0"
"jamui","bihar","Tola Ledwara","238.0","259870.0",784,416,368,358,234,124,415,219,196,"4","1","1","1","1","5.0","1.0","2.0","1.0","1.0"
"jamui","bihar","Tola Ghaghara","238.0","259871.0",1229,636,593,517,370,147,585,316,269,"7","1","2","3","1","5.0","1.0","2.0","1.0","1.0"
"jamui","bihar","Tola Bhalshumha","238.0","259872.0",547,276,271,291,178,113,258,142,116,"5","1","1","2","1","6.0","1.0","2.0","2.0","1.0"
"jamui","bihar","Tola Pandedih","238.0","259873.0",289,148,141,122,74,48,163,89,74,"5","1","1","2","1","5.0","1.0","2.0","1.0","1.0"
"jamui","bihar","Tola Belbana","238.0","259875.0",159,84,75,73,48,25,41,36,5,"5","1","1","2","1","6.0","1.0","2.0","2.0","1.0"
"jamui","bihar","Tola Bone","238.0","259876.0",1049,574,475,632,417,215,568,310,258,"6","1","2","2","1","7.0","3.0","1.0","2.0","1.0"
"jamui","bihar","Tola Surjudih","238.0","259879.0",91,49,42,47,31,16,43,28,15,"4","1","1","1","1","5.0","1.0","2.0","1.0","1.0"
"jamui","bihar","Tola Naiadih","238.0","259881.0",277,135,142,64,41,23,81,64,17,"5","1","1","2","1","5.0","1.0","2.0","1.0","1.0"
"jamui","bihar","Tola Turkadih","238.0","259882.0",303,155,148,79,45,34,67,65,2,"5","1","1","2","1","7.0","1.0","2.0","3.0","1.0"
"jamui","bihar","Tola Pajradih","238.0","259883.0",237,129,108,187,107,80,80,64,16,"6","1","2","2","1","5.0","1.0","2.0","1.0","1.0"
"jamui","bihar","Tola Sirmandih","238.0","259886.0",401,202,199,112,81,31,123,120,3,"5","1","1","2","1","6.0","1.0","2.0","2.0","1.0"
"jamui","bihar","Tola Satsala","238.0","259888.0",440,233,207,305,187,118,233,137,96,"5","1","1","2","1","6.0","1.0","2.0","2.0","1.0"
"jamui","bihar","Tola Kandani","238.0","259889.0",183,93,90,70,49,21,50,46,4,"4","1","1","1","1","5.0","1.0","2.0","1.0","1.0"
"jamui","bihar","Tola Baratanr","238.0","259890.0",1039,507,532,388,252,136,510,294,216,"6","1","2","2","1","7.0","1.0","2.0","3.0","1.0"
"jamui","bihar","Tola Barahara","238.0","259893.0",38,17,21,19,12,7,23,13,10,"5","1","1","2","1","5.0","1.0","2.0","1.0","1.0"
"jamui","bihar","Tola Gadikiajori","238.0","259896.0",2308,1218,1090,1407,851,556,857,600,257,"4","1","1","1","1","5.0","1.0","2.0","1.0","1.0"
"jamui","bihar","Tola Baliadabar","238.0","259898.0",361,192,169,132,82,50,122,80,42,"4","1","1","1","1","5.0","1.0","2.0","1.0","1.0"
"jamui","bihar","Tola Maldedih","238.0","259899.0",718,374,344,382,245,137,409,209,200,"6","1","2","2","1","5.0","1.0","2.0","1.0","1.0"
"jamui","bihar","Tola Badia","238.0","259900.0",439,226,213,119,80,39,241,124,117,"5","1","1","2","1","5.0","1.0","2.0","1.0","1.0"
"jamui","bihar","Tola Nawadih","238.0","259901.0",439,229,210,91,51,40,258,132,126,"5","1","1","2","1","5.0","1.0","2.0","1.0","1.0"
"jamui","bihar","Tola Meghni","238.0","259902.0",90,47,43,34,22,12,72,40,32,"5","1","2","1","1","5.0","1.0","2.0","1.0","1.0"
"jamui","bihar","Tola Madhupur","238.0","259903.0",211,114,97,59,43,16,173,94,79,"5","1","2","1","1","5.0","1.0","2.0","1.0","1.0"
"jamui","bihar","Tola Phariatadih","238.0","259910.0",1037,566,471,384,269,115,562,299,263,"5","1","2","1","1","5.0","1.0","2.0","1.0","1.0"
"jamui","bihar","Tola Tetaria","238.0","259917.0",380,199,181,114,77,37,190,100,90,"4","1","1","1","1","5.0","1.0","2.0","1.0","1.0"
"jamui","bihar","Tola Bagwa","238.0","259922.0",103,59,44,45,34,11,54,27,27,"6","1","1","3","1","5.0","1.0","2.0","1.0","1.0"
"jamui","bihar","Tola Dhawatanr","238.0","259924.0",161,79,82,82,47,35,83,39,44,"6","1","1","3","1","5.0","1.0","2.0","1.0","1.0"
"jamui","bihar","Tola Durgatari","238.0","259925.0",119,55,64,72,33,39,58,28,30,"6","1","1","3","1","5.0","1.0","2.0","1.0","1.0"
"jamui","bihar","Tola Indodih","238.0","259926.0",221,117,104,72,51,21,63,60,3,"5","1","2","1","1","7.0","3.0","2.0","1.0","1.0"
"jamui","bihar","Chhatiaini","238.0","258519.0",1836,955,881,706,484,222,873,478,395,"7","2","2","2","1","7.0","2.0","2.0","2.0","1.0"
"jamui","bihar","Dinnagar","238.0","258520.0",6351,3245,3106,2452,1507,945,3211,1776,1435,"8","2","1","2","3","7.0","2.0","2.0","2.0","1.0"
"jamui","bihar","Malikpur","238.0","258521.0",345,177,168,221,126,95,196,101,95,"7","2","2","2","1","7.0","2.0","2.0","2.0","1.0"
"jamui","bihar","Maher","238.0","258522.0",559,282,277,258,149,109,207,136,71,"6","2","1","2","1","7.0","2.0","2.0","2.0","1.0"
"jamui","bihar","Jekhra","238.0","258523.0",886,463,423,527,302,225,331,222,109,"7","2","2","2","1","7.0","2.0","2.0","2.0","1.0"
"jamui","bihar","Kaiar","238.0","258524.0",5570,2874,2696,2891,1766,1125,1998,1392,606,"7","2","2","2","1","7.0","2.0","2.0","2.0","1.0"
"jamui","bihar","Balda","238.0","258525.0",2069,1085,984,752,512,240,1078,567,511,"8","2","2","3","1","6.0","1.0","2.0","2.0","1.0"
"jamui","bihar","Dhanawan","238.0","258526.0",2753,1468,1285,1396,855,541,1112,684,428,"7","2","2","2","1","7.0","2.0","2.0","2.0","1.0"
"jamui","bihar","Mohanpur","238.0","258527.0",1988,1035,953,1060,660,400,883,575,308,"7","2","2","2","1","7.0","2.0","2.0","2.0","1.0"
"jamui","bihar","Sagawan","238.0","258528.0",1199,594,605,534,325,209,352,304,48,"7","2","2","2","1","7.0","2.0","2.0","2.0","1.0"
"jamui","bihar","Sahora","238.0","258529.0",3013,1607,1406,1516,982,534,907,632,275,"9","2","2","2","3","7.0","2.0","2.0","2.0","1.0"
"jamui","bihar","Kolhna","238.0","258530.0",3252,1692,1560,1498,933,565,1446,949,497,"7","2","2","2","1","7.0","2.0","2.0","2.0","1.0"
"jamui","bihar","Mandra","238.0","258531.0",879,423,456,195,133,62,259,153,106,"7","2","2","2","1","7.0","2.0","2.0","2.0","1.0"
"jamui","bihar","Sanpo","238.0","258532.0",2211,1153,1058,542,406,136,1082,575,507,"6","2","1","2","1","7.0","2.0","2.0","2.0","1.0"
"jamui","bihar","Noni","238.0","258533.0",2437,1267,1170,1281,748,533,1163,717,446,"7","2","2","2","1","7.0","2.0","2.0","2.0","1.0"
"jamui","bihar","Kaitha","238.0","258534.0",2042,1068,974,1278,661,617,803,512,291,"9","2","2","2","3","7.0","2.0","2.0","2.0","1.0"
"jamui","bihar","Tajpur","238.0","258535.0",601,318,283,346,209,137,227,156,71,"9","2","2","2","3","7.0","2.0","2.0","2.0","1.0"
"jamui","bihar","Sewe","238.0","258539.0",1602,870,732,892,518,374,765,508,257,"9","2","2","2","3","6.0","2.0","2.0","1.0","1.0"
"jamui","bihar","Dihri","238.0","258540.0",1018,520,498,493,308,185,437,288,149,"6","2","1","2","1","7.0","2.0","2.0","2.0","1.0"
"jamui","bihar","Dhanar","238.0","258542.0",1445,736,709,887,493,394,464,335,129,"6","2","1","2","1","7.0","2.0","2.0","2.0","1.0"
"jamui","bihar","Uchaunr","238.0","258543.0",822,405,417,402,205,197,268,231,37,"9","2","2","3","2","7.0","2.0","2.0","2.0","1.0"
"jamui","bihar","Chaurasa","238.0","258545.0",3416,1739,1677,1957,1113,844,1152,812,340,"7","2","2","2","1","7.0","2.0","2.0","2.0","1.0"
"jamui","bihar","Telar","238.0","258546.0",2274,1202,1072,1022,638,384,945,623,322,"7","2","2","2","1","7.0","2.0","2.0","2.0","1.0"
"jamui","bihar","Chandardip","238.0","258547.0",2438,1254,1184,1384,776,608,531,497,34,"9","2","2","3","2","7.0","2.0","2.0","2.0","1.0"
"jamui","bihar","Bela","238.0","258548.0",1695,863,832,701,384,317,573,443,130,"9","2","2","3","2","7.0","2.0","2.0","2.0","1.0"
"jamui","bihar","Arha","238.0","258549.0",6548,3360,3188,4034,2196,1838,1622,1452,170,"9","2","2","3","2","7.0","2.0","2.0","2.0","1.0"
"jamui","bihar","Parsa Buzurg","238.0","258550.0",2168,1114,1054,822,535,287,556,456,100,"7","2","2","2","1","7.0","2.0","2.0","2.0","1.0"
"jamui","bihar","Palsa","238.0","258553.0",1730,923,807,1018,589,429,838,488,350,"7","2","1","2","2","7.0","2.0","2.0","2.0","1.0"
"jamui","bihar","Parsanwan","238.0","258554.0",1438,736,702,637,414,223,751,388,363,"7","2","2","2","1","7.0","2.0","2.0","2.0","1.0"
"jamui","bihar","Kharagpur","238.0","258556.0",1760,906,854,778,518,260,749,409,340,"7","2","2","2","1","7.0","1.0","2.0","3.0","1.0"
"jamui","bihar","Amba","238.0","258558.0",968,496,472,468,286,182,494,254,240,"7","2","1","3","1","6.0","2.0","2.0","1.0","1.0"
"jamui","bihar","Bahchha","238.0","258560.0",1044,535,509,546,310,236,405,226,179,"7","2","2","2","1","7.0","2.0","2.0","2.0","1.0"
"jamui","bihar","Danr","238.0","258561.0",2217,1137,1080,1247,664,583,726,491,235,"9","2","2","2","3","7.0","2.0","2.0","2.0","1.0"
"jamui","bihar","Islamnagar","238.0","258562.0",7393,3806,3587,2801,1795,1006,2586,1765,821,"7","2","2","2","1","7.0","2.0","2.0","2.0","1.0"
"jamui","bihar","Ram Sagar Hilsa","238.0","258564.0",3282,1714,1568,1170,772,398,1389,968,421,"6","2","1","2","1","6.0","2.0","2.0","1.0","1.0"
"jamui","bihar","Kodwaria","238.0","258567.0",3104,1618,1486,1258,797,461,1345,772,573,"5","1","1","2","1","6.0","1.0","2.0","2.0","1.0"
"jamui","bihar","Manpur","238.0","258568.0",2541,1320,1221,1293,812,481,805,619,186,"7","2","2","2","1","7.0","2.0","2.0","2.0","1.0"
"jamui","bihar","Darkha","238.0","258570.0",3943,2099,1844,2106,1287,819,1628,1060,568,"10","2","2","3","3","7.0","2.0","2.0","2.0","1.0"
"jamui","bihar","Pursanda","238.0","258571.0",3301,1739,1562,1390,915,475,1450,891,559,"6","2","1","2","1","7.0","2.0","2.0","2.0","1.0"
"jamui","bihar","Sundar Badh","238.0","258572.0",588,301,287,316,199,117,210,149,61,"6","2","2","1","1","7.0","2.0","2.0","2.0","1.0"
"jamui","bihar","Bala Pursanda","238.0","258573.0",1820,948,872,864,578,286,649,414,235,"7","2","2","2","1","7.0","2.0","2.0","2.0","1.0"
"jamui","bihar","Dhopdeoghat","238.0","258575.0",198,101,97,69,35,34,81,49,32,"5","2","1","1","1","7.0","2.0","2.0","2.0","1.0"
"jamui","bihar","Risdih","238.0","258576.0",1478,744,734,592,348,244,888,466,422,"8","2","2","3","1","7.0","2.0","2.0","2.0","1.0"
"jamui","bihar","Gahlaur","238.0","258577.0",2702,1436,1266,984,663,321,982,657,325,"5","2","1","1","1","6.0","2.0","2.0","1.0","1.0"
"jamui","bihar","Mohammadpur","238.0","258578.0",2177,1118,1059,644,440,204,795,530,265,"7","2","1","3","1","6.0","1.0","2.0","2.0","1.0"
"jamui","bihar","Tola Nigoria","238.0","258860.0",718,359,359,297,153,144,357,177,180,"5","2","1","1","1","5.0","1.0","2.0","1.0","1.0"
"jamui","bihar","Tola Doma Mahra","238.0","258861.0",2015,1024,991,749,491,258,1147,576,571,"6","2","1","2","1","6.0","2.0","2.0","1.0","1.0"
"jamui","bihar","Tola Phoksa","238.0","258862.0",1651,901,750,468,337,131,749,435,314,"7","2","1","3","1","6.0","1.0","2.0","2.0","1.0"
"jamui","bihar","Tola Baijla","238.0","258863.0",3186,1570,1616,1366,789,577,1227,717,510,"6","2","2","1","1","6.0","2.0","2.0","1.0","1.0"
"jamui","bihar","Tola Saraia","238.0","258864.0",826,431,395,200,131,69,376,190,186,"6","2","2","1","1","6.0","2.0","2.0","1.0","1.0"
"jamui","bihar","Tola Gamharia","238.0","258865.0",715,380,335,487,275,212,202,196,6,"5","1","1","2","1","6.0","2.0","2.0","1.0","1.0"
"jamui","bihar","Tola Dhamana","238.0","258867.0",1022,507,515,350,262,88,543,279,264,"7","1","2","3","1","6.0","1.0","2.0","2.0","1.0"
"jamui","bihar","Tola Domai","238.0","258868.0",720,380,340,172,132,40,210,113,97,"5","1","2","1","1","6.0","2.0","2.0","1.0","1.0"
"jamui","bihar","Tola Dumarhar","238.0","258870.0",357,180,177,172,90,82,159,77,82,"6","1","2","2","1","5.0","1.0","1.0","2.0","1.0"
"jamui","bihar","Tola Sugwauran","238.0","258871.0",404,208,196,174,121,53,137,93,44,"7","2","2","2","1","7.0","2.0","2.0","2.0","1.0"
"jamui","bihar","Tola Tarkhangri","238.0","258872.0",491,247,244,206,126,80,237,112,125,"7","2","2","2","1","6.0","1.0","2.0","2.0","1.0"
"jamui","bihar","Tola Madhua","238.0","258874.0",188,89,99,81,53,28,81,43,38,"5","1","2","1","1","5.0","1.0","2.0","1.0","1.0"
"jamui","bihar","Tola Goriarwa","238.0","258875.0",541,285,256,242,168,74,342,185,157,"5","2","1","1","1","5.0","1.0","2.0","1.0","1.0"
"jamui","bihar","Tola Dhabatia","238.0","258877.0",641,333,308,365,241,124,297,163,134,"5","1","2","1","1","8.0","3.0","2.0","2.0","1.0"
"jamui","bihar","Tola Banjama","238.0","258878.0",743,392,351,413,265,148,302,195,107,"6","2","2","1","1","7.0","2.0","2.0","2.0","1.0"
"jamui","bihar","Tola Jogiatila","238.0","258880.0",1513,792,721,605,419,186,687,411,276,"6","2","2","1","1","5.0","1.0","2.0","1.0","1.0"
"jamui","bihar","Tola Sahia","238.0","258882.0",1848,968,880,734,507,227,1040,550,490,"5","1","1","2","1","6.0","2.0","2.0","1.0","1.0"
"jamui","bihar","Tola Kenuatanr","238.0","258883.0",340,174,166,104,62,42,167,84,83,"5","1","1","2","1","5.0","1.0","2.0","1.0","1.0"
"jamui","bihar","Tola Burhikhar","238.0","258885.0",1541,816,725,882,551,331,787,427,360,"4","1","1","1","1","5.0","1.0","2.0","1.0","1.0"
"jamui","bihar","Tola Bhikha","238.0","258886.0",861,436,425,340,241,99,499,245,254,"6","2","2","1","1","6.0","2.0","2.0","1.0","1.0"
"jamui","bihar","Tola Pargaha","238.0","258887.0",2319,1205,1114,1195,741,454,1228,616,612,"6","1","1","3","1","7.0","1.0","2.0","3.0","1.0"
"jamui","bihar","Tola Chilko","238.0","258888.0",100,56,44,35,26,9,60,31,29,"9","3","2","3","1","5.0","1.0","2.0","1.0","1.0"
"jamui","bihar","Tola Semarka","238.0","258889.0",293,158,135,114,69,45,151,80,71,"6","2","2","1","1","6.0","1.0","1.0","3.0","1.0"
"jamui","bihar","Tola Pananwa","238.0","258890.0",637,339,298,413,226,187,322,163,159,"4","1","1","1","1","5.0","1.0","2.0","1.0","1.0"
"jamui","bihar","Tola Chaukijor","238.0","258891.0",752,377,375,216,123,93,267,147,120,"4","1","1","1","1","5.0","1.0","2.0","1.0","1.0"
"jamui","bihar","Tola Ranga Kalan","238.0","258893.0",702,367,335,197,141,56,448,241,207,"6","1","2","2","1","5.0","1.0","2.0","1.0","1.0"
"jamui","bihar","Tola Lohjara","238.0","258894.0",625,337,288,197,143,54,334,165,169,"7","1","2","3","1","6.0","1.0","2.0","2.0","1.0"
"jamui","bihar","Tola Gonda","238.0","258896.0",519,297,222,274,188,86,241,140,101,"4","1","1","1","1","6.0","1.0","2.0","2.0","1.0"
"jamui","bihar","Tola Gobindpur","238.0","258898.0",2810,1454,1356,1062,712,350,1462,773,689,"6","1","2","2","1","6.0","1.0","2.0","2.0","1.0"
"jamui","bihar","Tola kita Naukadih","238.0","258901.0",44,22,22,0,0,0,34,17,17,"5","1","2","1","1","6.0","1.0","2.0","2.0","1.0"
"jamui","bihar","Tola Teliadih","238.0","258902.0",2766,1399,1367,1291,841,450,1284,678,606,"6","1","2","2","1","5.0","1.0","2.0","1.0","1.0"
"jamui","bihar","Tola kita Naua Kura","238.0","258903.0",901,475,426,392,264,128,345,220,125,"4","1","1","1","1","5.0","1.0","2.0","1.0","1.0"
"jamui","bihar","Tola kita khairan","238.0","258904.0",2838,1454,1384,942,631,311,1427,702,725,"6","1","1","3","1","7.0","2.0","2.0","2.0","1.0"
"jamui","bihar","Tola kita Bat Bajra","238.0","258905.0",1967,1044,923,540,401,139,1038,545,493,"6","1","1","3","1","6.0","2.0","2.0","1.0","1.0"
"jamui","bihar","Tola kita Kusauna","238.0","258906.0",780,386,394,203,151,52,300,146,154,"5","1","2","1","1","7.0","2.0","2.0","2.0","1.0"
"jamui","bihar","Tola Bhelbindha","238.0","258907.0",1198,590,608,538,356,182,623,289,334,"6","1","2","2","1","6.0","1.0","2.0","2.0","1.0"
"jamui","bihar","Tola Kubri","238.0","258908.0",522,282,240,165,113,52,255,128,127,"5","1","2","1","1","6.0","2.0","2.0","1.0","1.0"
"jamui","bihar","Tola Sabaijor","238.0","258909.0",2076,1059,1017,846,560,286,915,572,343,"4","1","1","1","1","7.0","1.0","2.0","3.0","1.0"
"jamui","bihar","Tola Karma","238.0","258910.0",2664,1421,1243,781,570,211,1383,740,643,"4","1","1","1","1","5.0","2.0","1.0","1.0","1.0"
"jamui","bihar","Tola Datkichwa","238.0","258911.0",610,314,296,226,156,70,341,180,161,"6","2","2","1","1","6.0","1.0","2.0","2.0","1.0"
"jamui","bihar","Tola Kaljugaha","238.0","258912.0",595,310,285,318,223,95,217,149,68,"4","1","1","1","1","7.0","1.0","2.0","3.0","1.0"
"jamui","bihar","Tola Kabar Kalan","238.0","258915.0",559,281,278,293,167,126,268,132,136,"4","1","1","1","1","5.0","1.0","2.0","1.0","1.0"
"jamui","bihar","Tola Kanan","238.0","258918.0",5545,2847,2698,2559,1664,895,2677,1395,1282,"7","2","2","2","1","6.0","1.0","2.0","2.0","1.0"
"jamui","bihar","Tola Fatehpur","238.0","258919.0",1189,605,584,652,406,246,443,326,117,"8","2","2","3","1","7.0","2.0","2.0","2.0","1.0"
"jamui","bihar","Tola Khoriparas","238.0","258922.0",978,504,474,515,330,185,412,255,157,"6","2","2","1","1","7.0","2.0","2.0","2.0","1.0"
"jamui","bihar","Tola Patao","238.0","258923.0",1297,680,617,648,438,210,449,284,165,"7","2","2","2","1","7.0","2.0","2.0","2.0","1.0"
"jamui","bihar","Tola Gongakura","238.0","258931.0",604,300,304,276,169,107,248,146,102,"6","2","2","1","1","5.0","1.0","2.0","1.0","1.0"
"jamui","bihar","Tola Chito Chak","238.0","258934.0",2996,1584,1412,1351,912,439,1581,823,758,"7","3","2","1","1","8.0","2.0","2.0","3.0","1.0"
"jamui","bihar","Tola Baramasia","238.0","258935.0",2640,1359,1281,897,494,403,1272,681,591,"8","2","2","3","1","6.0","2.0","2.0","1.0","1.0"
"jamui","bihar","Tola Mahapur","238.0","258936.0",2974,1547,1427,1297,877,420,1391,722,669,"7","2","1","3","1","7.0","2.0","2.0","2.0","1.0"
"jamui","bihar","Tola Tumbapahar","238.0","258937.0",2837,1436,1401,1023,666,357,1314,760,554,"4","1","1","1","1","7.0","2.0","2.0","2.0","1.0"
"jamui","bihar","Tola Auria","238.0","258938.0",2675,1399,1276,1305,870,435,1317,656,661,"6","2","2","1","1","6.0","2.0","2.0","1.0","1.0"
"jamui","bihar","Tola Burhnair","238.0","258939.0",690,352,338,238,132,106,328,171,157,"7","2","1","1","3","7.0","2.0","2.0","2.0","1.0"
"jamui","bihar","Tola Harna","238.0","258940.0",3097,1648,1449,1151,775,376,1429,787,642,"7","2","1","3","1","7.0","2.0","2.0","2.0","1.0"
"jamui","bihar","Tola Satighat","238.0","258941.0",2604,1354,1250,850,604,246,1250,621,629,"5","2","1","1","1","7.0","2.0","2.0","2.0","1.0"
"jamui","bihar","Tola Tetaria Khurd","238.0","258943.0",631,302,329,189,96,93,301,146,155,"7","2","1","3","1","7.0","2.0","2.0","2.0","1.0"
"jamui","bihar","Tola Chilko","238.0","258944.0",348,183,165,109,77,32,159,84,75,"4","1","1","1","1","5.0","1.0","2.0","1.0","1.0"
"jamui","bihar","Tola Tara Kura Nawadih","238.0","258946.0",785,386,399,347,226,121,446,220,226,"4","1","1","1","1","7.0","2.0","2.0","2.0","1.0"
"jamui","bihar","Tola Tara Kura Chhapa","238.0","258947.0",2045,1010,1035,633,447,186,974,502,472,"4","1","1","1","1","7.0","2.0","2.0","2.0","1.0"
"jamui","bihar","Tola Barajor","238.0","258948.0",12608,6505,6103,6548,4175,2373,5455,3101,2354,"7","1","2","3","1","6.0","1.0","2.0","2.0","1.0"
"jamui","bihar","Tola Harhanja","238.0","258949.0",1306,691,615,474,360,114,621,334,287,"6","1","1","3","1","7.0","2.0","2.0","2.0","1.0"
"jamui","bihar","Tola Chhapa","238.0","258950.0",5139,2680,2459,1838,1319,519,2062,1307,755,"5","1","1","2","1","5.0","1.0","2.0","1.0","1.0"
"jamui","bihar","Tola Baratanr","238.0","258951.0",625,292,333,95,67,28,314,162,152,"5","1","1","2","1","5.0","1.0","2.0","1.0","1.0"
"jamui","bihar","Tola Karhara","238.0","258952.0",3001,1526,1475,1186,789,397,1554,828,726,"6","1","1","3","1","7.0","1.0","2.0","3.0","1.0"
"jamui","bihar","Tola Karma","238.0","258953.0",765,424,341,293,190,103,163,158,5,"6","1","2","2","1","6.0","1.0","2.0","2.0","1.0"
"jamui","bihar","Tola Goradamgi","238.0","258954.0",281,144,137,49,40,9,135,67,68,"4","1","1","1","1","5.0","1.0","2.0","1.0","1.0"
"jamui","bihar","Tola Kathautia Kalan","238.0","258955.0",188,99,89,68,49,19,99,48,51,"4","1","1","1","1","5.0","1.0","2.0","1.0","1.0"
"jamui","bihar","Tola Kathautia Kurd","238.0","258956.0",232,118,114,93,50,43,125,65,60,"4","1","1","1","1","5.0","1.0","2.0","1.0","1.0"
"jamui","bihar","Tola Balapanrar","238.0","258957.0",1093,573,520,477,339,138,543,280,263,"5","1","1","2","1","5.0","1.0","2.0","1.0","1.0"
"jamui","bihar","Tola Fatehpur","238.0","258958.0",1048,523,525,293,186,107,517,262,255,"6","1","1","3","1","5.0","1.0","2.0","1.0","1.0"
"jamui","bihar","Tola Dumarmah","238.0","258959.0",2421,1164,1257,1232,737,495,903,532,371,"5","1","2","1","1","6.0","2.0","2.0","1.0","1.0"
"jamui","bihar","Tola Sikardih","238.0","258960.0",874,447,427,446,308,138,472,240,232,"5","2","1","1","1","5.0","2.0","1.0","1.0","1.0"
"jamui","bihar","Tola Kauatol","238.0","258961.0",685,345,340,101,78,23,357,166,191,"5","1","2","1","1","5.0","1.0","2.0","1.0","1.0"
"jamui","bihar","Tola Porsil","238.0","258962.0",72,39,33,1,0,1,43,24,19,"5","1","1","2","1","6.0","1.0","2.0","2.0","1.0"
"jamui","bihar","Tola Ukharia","238.0","258964.0",185,104,81,66,50,16,80,48,32,"4","1","1","1","1","5.0","1.0","2.0","1.0","1.0"
"jamui","bihar","Tola Asta","238.0","258965.0",1790,910,880,632,412,220,1099,573,526,"4","1","1","1","1","8.0","2.0","2.0","3.0","1.0"
"jamui","bihar","Tola Dario","238.0","258966.0",1220,651,569,499,350,149,544,358,186,"5","1","2","1","1","6.0","2.0","2.0","1.0","1.0"
"jamui","bihar","Tola Borwa","238.0","258967.0",2067,1085,982,1289,822,467,959,549,410,"5","1","2","1","1","6.0","2.0","2.0","1.0","1.0"
"jamui","bihar","Tola Bishunpur","238.0","258969.0",446,214,232,175,101,74,268,126,142,"4","1","1","1","1","5.0","1.0","2.0","1.0","1.0"
"jamui","bihar","Tola Dongajharna","238.0","258971.0",244,120,124,61,38,23,117,58,59,"4","1","1","1","1","7.0","2.0","1.0","3.0","1.0"
"jamui","bihar","Tola Bakhori Bathan","238.0","258972.0",416,226,190,191,126,65,232,122,110,"4","1","1","1","1","6.0","2.0","2.0","1.0","1.0"
"jamui","bihar","Tola Maniktham","238.0","258973.0",762,390,372,111,80,31,388,211,177,"4","1","1","1","1","6.0","2.0","2.0","1.0","1.0"
"jamui","bihar","Tola Narganjo","238.0","258974.0",2009,1069,940,885,553,332,1245,655,590,"4","1","1","1","1","7.0","2.0","2.0","2.0","1.0"
"jamui","bihar","Tola Siritanr","238.0","258975.0",26,12,14,13,10,3,12,5,7,"4","1","1","1","1","8.0","2.0","2.0","3.0","1.0"
"jamui","bihar","Tola Tithichak","238.0","258976.0",293,155,138,89,53,36,163,83,80,"5","2","1","1","1","6.0","2.0","1.0","2.0","1.0"
"jamui","bihar","Tola Kumhaini","238.0","258977.0",311,163,148,148,107,41,163,83,80,"4","1","1","1","1","6.0","2.0","2.0","1.0","1.0"
"jamui","bihar","Tola Pidron","238.0","258978.0",123,63,60,52,32,20,52,26,26,"4","1","1","1","1","5.0","1.0","2.0","1.0","1.0"
"jamui","bihar","Tola Agaria Kalan","238.0","258979.0",227,113,114,38,24,14,127,60,67,"5","2","1","1","1","5.0","1.0","2.0","1.0","1.0"
"jamui","bihar","Tola Rajla Kalan","238.0","258981.0",3552,1819,1733,1612,1047,565,1709,947,762,"6","2","2","1","1","8.0","2.0","2.0","3.0","1.0"
"jamui","bihar","Tola Rajla Khurd","238.0","258982.0",846,426,420,84,66,18,374,187,187,"5","2","1","1","1","5.0","1.0","2.0","1.0","1.0"
"jamui","bihar","Tola Tabhwa","238.0","258983.0",4188,2199,1989,1633,1112,521,1851,1021,830,"5","2","1","1","1","6.0","2.0","2.0","1.0","1.0"
"jamui","bihar","Tola Naugain","238.0","258984.0",1198,646,552,587,399,188,529,318,211,"6","1","1","3","1","6.0","2.0","2.0","1.0","1.0"
"jamui","bihar","Tola Karma","238.0","258986.0",334,171,163,127,83,44,152,86,66,"4","1","1","1","1","5.0","1.0","2.0","1.0","1.0"
"jamui","bihar","Tola Parasi","238.0","258988.0",2007,1045,962,1017,656,361,886,539,347,"8","2","2","3","1","6.0","2.0","2.0","1.0","1.0"
"jamui","bihar","Tola Dhakio","238.0","258989.0",233,117,116,86,53,33,76,43,33,"4","1","1","1","1","5.0","2.0","1.0","1.0","1.0"
"jamui","bihar","Tola Suwarkar","238.0","259125.0",552,287,265,167,132,35,250,159,91,"5","1","2","1","1","6.0","1.0","2.0","2.0","1.0"
"jamui","bihar","Salaiya Kasoia","238.0","259126.0",1770,955,815,882,607,275,928,495,433,"5","1","2","1","1","5.0","1.0","2.0","1.0","1.0"
"jamui","bihar","Bojhait","238.0","259127.0",2697,1403,1294,1008,677,331,1312,699,613,"4","1","1","1","1","5.0","1.0","2.0","1.0","1.0"
"jamui","bihar","Badidih","238.0","259128.0",1901,960,941,681,453,228,751,484,267,"4","1","1","1","1","5.0","2.0","1.0","1.0","1.0"
"jamui","bihar","Nim Nawada","238.0","259133.0",8199,4253,3946,3090,2098,992,3380,2122,1258,"5","1","2","1","1","6.0","2.0","2.0","1.0","1.0"
"jamui","bihar","Tola Jhundo","238.0","259134.0",10506,5568,4938,5443,3343,2100,4599,2850,1749,"6","1","1","3","1","7.0","2.0","2.0","2.0","1.0"
"jamui","bihar","Tola Kewalpharaita","238.0","259135.0",3622,1873,1749,1659,1080,579,1643,983,660,"8","2","2","3","1","7.0","2.0","2.0","2.0","1.0"
"jamui","bihar","Mange  Chapri","238.0","259136.0",500,260,240,185,97,88,158,123,35,"6","1","2","2","1","7.0","2.0","2.0","2.0","1.0"
"jamui","bihar","Kendua","238.0","259137.0",485,256,229,345,191,154,140,121,19,"9","2","2","2","3","7.0","2.0","2.0","2.0","1.0"
"jamui","bihar","Kendua","238.0","259138.0",1409,709,700,560,313,247,362,334,28,"6","2","1","2","1","7.0","2.0","2.0","2.0","1.0"
"jamui","bihar","Dehuridih","238.0","259139.0",2272,1154,1118,1058,654,404,1001,593,408,"6","1","1","3","1","6.0","1.0","2.0","2.0","1.0"
"jamui","bihar","Majhgain","238.0","259140.0",1912,1016,896,1158,678,480,697,454,243,"7","2","2","2","1","7.0","1.0","2.0","3.0","1.0"
"jamui","bihar","Kagesar","238.0","259142.0",2893,1530,1363,1661,1052,609,1215,730,485,"8","2","2","3","1","7.0","2.0","2.0","2.0","1.0"
"jamui","bihar","tihia","238.0","259143.0",2439,1273,1166,1661,930,731,817,577,240,"7","2","2","2","1","7.0","2.0","2.0","2.0","1.0"
"jamui","bihar","Chuan","238.0","259144.0",4657,2434,2223,2529,1568,961,1890,1254,636,"7","2","2","2","1","7.0","2.0","2.0","2.0","1.0"
"jamui","bihar","Gangti","238.0","259145.0",2455,1263,1192,1175,721,454,1283,698,585,"7","2","2","2","1","6.0","2.0","2.0","1.0","1.0"
"jamui","bihar","Kerakado","238.0","259146.0",2521,1335,1186,1139,744,395,1117,632,485,"6","1","2","2","1","7.0","2.0","2.0","2.0","1.0"
"jamui","bihar","Chihutia","238.0","259147.0",1388,751,637,798,513,285,516,343,173,"6","1","2","2","1","7.0","2.0","2.0","2.0","1.0"
"jamui","bihar","Bela","238.0","259148.0",4123,2194,1929,2224,1365,859,1892,1076,816,"6","1","2","2","1","6.0","2.0","1.0","2.0","1.0"
"jamui","bihar","Khandaich","238.0","259149.0",10061,5231,4830,5088,3172,1916,3280,2526,754,"7","2","2","2","1","7.0","2.0","2.0","2.0","1.0"
"jamui","bihar","Sagdaha","238.0","259150.0",1631,868,763,1082,653,429,498,410,88,"8","2","2","3","1","8.0","2.0","2.0","3.0","1.0"
"jamui","bihar","Bhandra","238.0","259151.0",1317,661,656,767,467,300,372,303,69,"8","2","2","3","1","8.0","2.0","2.0","3.0","1.0"
"jamui","bihar","Chancho","238.0","259152.0",781,422,359,488,304,184,352,221,131,"8","2","2","3","1","5.0","1.0","2.0","1.0","1.0"
"jamui","bihar","Dabil","238.0","259153.0",5095,2668,2427,2582,1698,884,1844,1232,612,"7","2","2","2","1","7.0","2.0","2.0","2.0","1.0"
"jamui","bihar","Nariana","238.0","259156.0",1927,1017,910,1004,616,388,647,448,199,"7","2","1","3","1","8.0","2.0","2.0","1.0","3.0"
"jamui","bihar","Jitjhingoi","238.0","259158.0",6557,3402,3155,3402,2172,1230,3206,1766,1440,"8","2","2","3","1","6.0","2.0","1.0","2.0","1.0"
"jamui","bihar","Baghakhanr","238.0","259159.0",571,276,295,326,179,147,176,150,26,"5","2","1","1","1","7.0","2.0","2.0","2.0","1.0"
"jamui","bihar","Mangobandar","238.0","259160.0",9942,5171,4771,5164,3136,2028,3881,2438,1443,"8","2","2","3","1","7.0","2.0","2.0","2.0","1.0"
"jamui","bihar","Banpur","238.0","259162.0",5836,3068,2768,2997,1824,1173,2273,1372,901,"7","2","2","2","1","7.0","2.0","2.0","2.0","1.0"
"jamui","bihar","Bariarpur","238.0","259163.0",2501,1338,1163,1209,746,463,1212,698,514,"5","1","2","1","1","6.0","2.0","2.0","1.0","1.0"
"jamui","bihar","Sakdari","238.0","259164.0",1361,693,668,506,302,204,673,359,314,"5","2","1","1","1","6.0","2.0","2.0","1.0","1.0"
"jamui","bihar","Harni","238.0","259165.0",2734,1387,1347,1132,741,391,1265,689,576,"6","2","2","1","1","6.0","2.0","2.0","1.0","1.0"
"jamui","bihar","Khalari","238.0","259166.0",956,476,480,345,216,129,601,303,298,"5","2","1","1","1","6.0","2.0","2.0","1.0","1.0"
"jamui","bihar","Karitanr","238.0","259168.0",1764,929,835,933,593,340,655,442,213,"6","2","2","1","1","6.0","2.0","2.0","1.0","1.0"
"jamui","bihar","Gorhi","238.0","259169.0",10516,5575,4941,4832,2980,1852,3471,2575,896,"6","2","2","1","1","5.0","1.0","2.0","1.0","1.0"
"jamui","bihar","Sokho","238.0","259170.0",4197,2182,2015,1791,1118,673,1479,1062,417,"4","1","1","1","1","5.0","1.0","2.0","1.0","1.0"
"jamui","bihar","Arnawan Bank","238.0","259171.0",6782,3449,3333,2682,1719,963,2915,1763,1152,"5","1","2","1","1","5.0","1.0","2.0","1.0","1.0"
"jamui","bihar","Mainijor","238.0","259172.0",4308,2182,2126,1850,1124,726,1731,988,743,"5","1","2","1","1","6.0","2.0","2.0","1.0","1.0"
"jamui","bihar","Gadi Bishunpur","238.0","259173.0",8874,4579,4295,4075,2499,1576,3373,2279,1094,"5","1","2","1","1","5.0","1.0","2.0","1.0","1.0"
"jamui","bihar","Rajaun","238.0","259174.0",962,516,446,402,302,100,435,279,156,"5","1","2","1","1","5.0","1.0","2.0","1.0","1.0"
"jamui","bihar","Tola Prembathan","238.0","259175.0",94,48,46,61,34,27,31,17,14,"5","1","2","1","1","7.0","1.0","2.0","3.0","1.0"
"jamui","bihar","Tola Teliachhourat","238.0","259176.0",437,244,193,180,105,75,138,111,27,"4","1","1","1","1","6.0","1.0","2.0","2.0","1.0"
"jamui","bihar","Tola Panbajan","238.0","259177.0",925,471,454,335,233,102,542,263,279,"6","1","1","3","1","7.0","2.0","2.0","2.0","1.0"
"jamui","bihar","Tola Ghotari","238.0","259179.0",181,92,89,90,51,39,70,43,27,"6","1","2","2","1","6.0","1.0","2.0","2.0","1.0"
"jamui","bihar","Tola Pachpahri","238.0","259180.0",135,68,67,48,30,18,72,38,34,"5","2","1","1","1","7.0","2.0","2.0","2.0","1.0"
"jamui","bihar","Tola Bagmadamgi","238.0","259183.0",296,147,149,102,73,29,143,76,67,"4","1","1","1","1","5.0","1.0","2.0","1.0","1.0"
"jamui","bihar","Tola Bhithra","238.0","259184.0",1576,828,748,757,492,265,835,433,402,"5","1","1","2","1","7.0","2.0","2.0","2.0","1.0"
"jamui","bihar","Tola Kurkuta","238.0","259185.0",475,248,227,230,156,74,286,151,135,"4","1","1","1","1","7.0","2.0","2.0","2.0","1.0"
"jamui","bihar","Tola Joktia","238.0","259186.0",611,308,303,277,142,135,326,164,162,"4","1","1","1","1","6.0","1.0","2.0","2.0","1.0"
"jamui","bihar","Tola Mahapur Khurd","238.0","259188.0",519,261,258,187,125,62,292,144,148,"6","1","1","2","2","6.0","1.0","2.0","2.0","1.0"
"jamui","bihar","Tola Hariharpur","238.0","259189.0",554,284,270,250,154,96,210,119,91,"5","1","1","2","1","6.0","1.0","2.0","2.0","1.0"
"jamui","bihar","Tola Lakaraha","238.0","259191.0",714,370,344,352,199,153,346,219,127,"5","1","2","1","1","5.0","1.0","2.0","1.0","1.0"
"jamui","bihar","Tola Loha","238.0","259192.0",1113,577,536,497,311,186,506,298,208,"5","2","1","1","1","7.0","1.0","2.0","3.0","1.0"
"jamui","bihar","Tola Salaia","238.0","259193.0",621,293,328,198,141,57,279,135,144,"4","1","1","1","1","5.0","1.0","1.0","2.0","1.0"
"jamui","bihar","Tola Lohthara","238.0","259194.0",757,372,385,291,193,98,397,177,220,"5","1","1","2","1","8.0","2.0","2.0","3.0","1.0"
"jamui","bihar","Tola Chandra","238.0","259195.0",206,109,97,80,47,33,110,53,57,"5","1","1","1","2","6.0","2.0","2.0","1.0","1.0"
"jamui","bihar","Tola Baijadih","238.0","259199.0",500,269,231,241,168,73,123,122,1,"6","2","2","1","1","8.0","2.0","2.0","3.0","1.0"
"jamui","bihar","Tola Silauna","238.0","259205.0",33,21,12,16,13,3,16,9,7,"5","2","1","1","1","6.0","2.0","2.0","1.0","1.0"
"jamui","bihar","Tola Dumri Khas","238.0","259207.0",2760,1450,1310,1755,1001,754,911,697,214,"8","2","2","3","1","8.0","2.0","2.0","3.0","1.0"
"jamui","bihar","Tola Koria","238.0","259208.0",463,254,209,201,147,54,243,126,117,"6","1","2","2","1","6.0","2.0","2.0","1.0","1.0"
"jamui","bihar","Tola Kuanbank","238.0","259210.0",851,465,386,350,257,93,408,214,194,"5","1","1","2","1","7.0","1.0","2.0","3.0","1.0"
"jamui","bihar","Tola Rakat Rohinia","238.0","259211.0",1884,997,887,598,398,200,946,548,398,"5","1","1","2","1","5.0","1.0","2.0","1.0","1.0"
"jamui","bihar","Tola Chauki","238.0","259213.0",671,345,326,342,215,127,236,147,89,"5","1","2","1","1","7.0","1.0","2.0","3.0","1.0"
"jamui","bihar","Tola Asnalbari","238.0","259214.0",258,132,126,92,61,31,131,63,68,"5","2","1","1","1","6.0","2.0","2.0","1.0","1.0"
"jamui","bihar","Tola Kandualbar","238.0","259215.0",1071,550,521,551,377,174,563,291,272,"5","2","1","1","1","7.0","2.0","2.0","2.0","1.0"
"jamui","bihar","Tola Bhalguha","238.0","259216.0",614,297,317,346,201,145,294,168,126,"4","1","1","1","1","6.0","1.0","2.0","2.0","1.0"
"jamui","bihar","Tola Raghunatha","238.0","259217.0",254,130,124,90,55,35,82,67,15,"5","2","1","1","1","6.0","2.0","2.0","1.0","1.0"
"jamui","bihar","Tola Tilbaria","238.0","259218.0",2228,1064,1164,660,421,239,1016,471,545,"4","1","1","1","1","6.0","1.0","2.0","2.0","1.0"
"jamui","bihar","Tola Mahathania","238.0","259220.0",268,134,134,92,70,22,132,66,66,"4","1","1","1","1","8.0","2.0","2.0","3.0","1.0"
"jamui","bihar","Tola Belabathan","238.0","259221.0",918,462,456,357,227,130,410,201,209,"6","1","2","2","1","6.0","2.0","2.0","1.0","1.0"
"jamui","bihar","Tola Kodwatanr","238.0","259222.0",245,125,120,98,65,33,142,77,65,"4","1","1","1","1","5.0","1.0","2.0","1.0","1.0"
"jamui","bihar","Tola Tharhi","238.0","259223.0",1712,866,846,477,306,171,742,419,323,"4","1","1","1","1","6.0","2.0","1.0","2.0","1.0"
"jamui","bihar","Tola Belamba","238.0","259224.0",2866,1488,1378,915,627,288,1404,701,703,"4","1","1","1","1","7.0","2.0","2.0","2.0","1.0"
"jamui","bihar","Tola Chhapardih","238.0","259225.0",1309,686,623,493,319,174,679,365,314,"7","1","2","3","1","6.0","2.0","2.0","1.0","1.0"
"jamui","bihar","Tola Lakhankiari","238.0","259226.0",4320,2165,2155,2031,1308,723,2479,1232,1247,"5","1","2","1","1","7.0","2.0","2.0","2.0","1.0"
"jamui","bihar","Tola Dhodhri","238.0","259227.0",4570,2339,2231,2101,1330,771,2314,1193,1121,"5","1","2","1","1","7.0","2.0","2.0","2.0","1.0"
"jamui","bihar","Tola Amjhari","238.0","259228.0",1712,851,861,722,452,270,930,443,487,"4","1","1","1","1","5.0","1.0","2.0","1.0","1.0"
"jamui","bihar","Tola Ukharia","238.0","259232.0",130,53,77,53,24,29,58,30,28,"4","1","1","1","1","7.0","2.0","2.0","2.0","1.0"
"jamui","bihar","Tola Tetaria","238.0","259234.0",1873,890,983,876,536,340,1011,474,537,"5","1","2","1","1","7.0","2.0","2.0","2.0","1.0"
"jamui","bihar","Tola Jirhulia","238.0","259235.0",204,107,97,45,31,14,138,75,63,"5","1","2","1","1","6.0","2.0","2.0","1.0","1.0"
"jamui","bihar","Tola Khairalewar","238.0","259236.0",567,304,263,228,160,68,277,162,115,"4","1","1","1","1","6.0","2.0","2.0","1.0","1.0"
"jamui","bihar","Tola Buchchi","238.0","259237.0",128,70,58,50,37,13,67,39,28,"4","1","1","1","1","6.0","2.0","2.0","1.0","1.0"
"jamui","bihar","Tola Bhelwa","238.0","259239.0",194,98,96,31,25,6,80,37,43,"4","1","1","1","1","5.0","1.0","2.0","1.0","1.0"
"jamui","bihar","Tola Sengwaria","238.0","259240.0",183,87,96,55,36,19,109,52,57,"5","2","1","1","1","5.0","1.0","2.0","1.0","1.0"
"jamui","bihar","Tola Asarhua","238.0","259242.0",1632,838,794,770,467,303,777,401,376,"7","2","2","2","1","7.0","1.0","2.0","3.0","1.0"
"jamui","bihar","Tola Thakur  Ahra","238.0","259243.0",740,395,345,375,239,136,356,180,176,"6","1","2","2","1","6.0","2.0","2.0","1.0","1.0"
"jamui","bihar","Tola Lalpur","238.0","259247.0",504,269,235,159,114,45,190,131,59,"4","1","1","1","1","5.0","1.0","2.0","1.0","1.0"
"jamui","bihar","Tola Khopariadih","238.0","259252.0",1475,740,735,793,455,338,633,321,312,"6","2","2","1","1","6.0","2.0","2.0","1.0","1.0"
"jamui","bihar","Tola Auraia","238.0","259253.0",1620,853,767,963,604,359,808,435,373,"6","2","2","1","1","8.0","2.0","2.0","3.0","1.0"
"jamui","bihar","Tola Kukurbhento","238.0","259258.0",187,108,79,106,72,34,84,50,34,"6","1","2","2","1","7.0","2.0","2.0","2.0","1.0"
"jamui","bihar","Tola Bharathpur","238.0","259259.0",1662,835,827,695,441,254,699,390,309,"5","1","2","1","1","6.0","2.0","2.0","1.0","1.0"
"jamui","bihar","Tola Bishunpur","238.0","259392.0",2215,1164,1051,962,674,288,1122,599,523,"4","1","1","1","1","5.0","1.0","2.0","1.0","1.0"
"jamui","bihar","Tola Rajaun","238.0","259393.0",3158,1653,1505,993,740,253,1581,796,785,"5","1","2","1","1","5.0","1.0","2.0","1.0","1.0"
"jamui","bihar","Tola Nawai Ahar","238.0","259398.0",476,247,229,91,77,14,203,117,86,"4","1","1","1","1","4.0","1.0","1.0","1.0","1.0"
"jamui","bihar","Tola Tetaria","238.0","259399.0",314,168,146,65,53,12,164,84,80,"6","3","1","1","1","5.0","2.0","1.0","1.0","1.0"
"jamui","bihar","Tola Baghakolo","238.0","259401.0",139,65,74,22,13,9,70,36,34,"5","1","2","1","1","6.0","2.0","2.0","1.0","1.0"
"jamui","bihar","Tola Barmania","238.0","259404.0",755,374,381,334,187,147,569,295,274,"4","1","1","1","1","6.0","2.0","2.0","1.0","1.0"
"jamui","bihar","Tola Dudhania","238.0","259405.0",667,340,327,154,109,45,311,192,119,"4","1","1","1","1","7.0","2.0","1.0","3.0","1.0"
"jamui","bihar","Tola Karhari","238.0","259406.0",1104,567,537,278,201,77,717,368,349,"4","1","1","1","1","7.0","1.0","2.0","3.0","1.0"
"jamui","bihar","Tola Mohanadih","238.0","259407.0",291,138,153,95,56,39,191,90,101,"5","1","2","1","1","5.0","1.0","2.0","1.0","1.0"
"jamui","bihar","Tola Bandarmara","238.0","259408.0",1072,544,528,353,219,134,569,277,292,"4","1","1","1","1","6.0","2.0","2.0","1.0","1.0"
"jamui","bihar","Tola Botbaria","238.0","259411.0",284,134,150,39,34,5,128,63,65,"4","1","1","1","1","5.0","1.0","2.0","1.0","1.0"
"jamui","bihar","Tola Lakhanpur","238.0","259412.0",54,28,26,7,5,2,27,15,12,"5","1","2","1","1","6.0","2.0","2.0","1.0","1.0"
"jamui","bihar","Gandar","238.0","259413.0",4486,2300,2186,2131,1390,741,2193,1288,905,"5","1","2","1","1","4.0","1.0","1.0","1.0","1.0"
"jamui","bihar","Tola Dahiari","238.0","259414.0",2706,1398,1308,1054,723,331,1304,743,561,"4","1","1","1","1","6.0","2.0","2.0","1.0","1.0"
"jamui","bihar","Tola Teliadesh","238.0","259417.0",541,280,261,209,137,72,255,147,108,"4","1","1","1","1","6.0","2.0","2.0","1.0","1.0"
"jamui","bihar","Tola Karyasair","238.0","259418.0",189,95,94,81,61,20,92,48,44,"5","1","2","1","1","6.0","2.0","2.0","1.0","1.0"
"jamui","bihar","Tola Itwa","238.0","259419.0",2254,1145,1109,828,581,247,842,605,237,"4","1","1","1","1","6.0","2.0","2.0","1.0","1.0"
"jamui","bihar","Tola Bhuraha","238.0","259421.0",774,409,365,378,264,114,436,226,210,"5","1","2","1","1","6.0","2.0","2.0","1.0","1.0"
"jamui","bihar","Tola Barmasia","238.0","259422.0",271,136,135,64,50,14,128,74,54,"4","1","1","1","1","6.0","2.0","2.0","1.0","1.0"
"jamui","bihar","Tola Hethbatia","238.0","259423.0",297,149,148,100,54,46,144,78,66,"4","1","1","1","1","5.0","2.0","1.0","1.0","1.0"
"jamui","bihar","Tola Amtaha","238.0","259427.0",30,14,16,9,4,5,19,10,9,"4","1","1","1","1","5.0","1.0","2.0","1.0","1.0"
"jamui","bihar","Tola Nawadih","238.0","259436.0",104,58,46,51,35,16,50,29,21,"4","1","1","1","1","5.0","1.0","2.0","1.0","1.0"
"jamui","bihar","Tola Ghutia","238.0","259440.0",125,74,51,83,55,28,60,32,28,"4","1","1","1","1","5.0","1.0","2.0","1.0","1.0"
"jamui","bihar","Tola Hendola","238.0","259441.0",137,79,58,81,50,31,63,32,31,"4","1","1","1","1","7.0","3.0","2.0","1.0","1.0"
"jamui","bihar","Tola Sumarmara","238.0","259447.0",154,75,79,13,10,3,72,38,34,"4","1","1","1","1","5.0","1.0","2.0","1.0","1.0"
"jamui","bihar","Tola Malakpur","238.0","259449.0",228,121,107,36,27,9,95,48,47,"4","1","1","1","1","5.0","1.0","2.0","1.0","1.0"
"jamui","bihar","Tola Dumardiha","238.0","259456.0",164,82,82,29,20,9,78,41,37,"4","1","1","1","1","6.0","3.0","1.0","1.0","1.0"
"jamui","bihar","Tola Purnadih","238.0","259458.0",60,30,30,17,12,5,33,15,18,"5","1","1","2","1","5.0","1.0","2.0","1.0","1.0"
"jamui","bihar","Tola Madhupur","238.0","259464.0",634,324,310,108,81,27,413,219,194,"5","1","2","1","1","5.0","1.0","2.0","1.0","1.0"
"jamui","bihar","Tola Goswarah","238.0","259468.0",345,176,169,49,39,10,157,84,73,"4","1","1","1","1","5.0","1.0","2.0","1.0","1.0"
"jamui","bihar","Tola Barmoria","238.0","259469.0",477,225,252,163,95,68,189,124,65,"5","2","1","1","1","5.0","1.0","2.0","1.0","1.0"
"jamui","bihar","Tola Dubardih","238.0","259471.0",85,48,37,19,13,6,38,21,17,"4","1","1","1","1","7.0","2.0","2.0","2.0","1.0"
"jamui","bihar","Tola Rajadumar","238.0","259472.0",325,165,160,80,51,29,189,101,88,"4","1","1","1","1","5.0","1.0","2.0","1.0","1.0"
"jamui","bihar","Tola Barakhutia","238.0","259474.0",396,196,200,125,77,48,210,101,109,"4","1","1","1","1","6.0","2.0","2.0","1.0","1.0"
"jamui","bihar","Tola Pipra","238.0","259481.0",391,198,193,197,130,67,277,143,134,"4","1","1","1","1","4.0","1.0","1.0","1.0","1.0"
"jamui","bihar","Tola Barmasia","238.0","259482.0",328,168,160,153,110,43,229,115,114,"4","1","1","1","1","5.0","2.0","1.0","1.0","1.0"
"jamui","bihar","Tola Kurwa","238.0","259483.0",420,207,213,185,128,57,272,133,139,"4","1","1","1","1","5.0","1.0","2.0","1.0","1.0"
"jamui","bihar","Tola Bamdah","238.0","259485.0",1742,893,849,1110,653,457,911,523,388,"5","1","2","1","1","5.0","1.0","2.0","1.0","1.0"
"jamui","bihar","Tola Tarakhar","238.0","259487.0",454,231,223,242,150,92,295,142,153,"5","2","1","1","1","5.0","1.0","2.0","1.0","1.0"
"jamui","bihar","Tola Domohan","238.0","259488.0",552,279,273,233,163,70,427,225,202,"6","2","2","1","1","5.0","1.0","2.0","1.0","1.0"
"jamui","bihar","Tola Majhlakola","238.0","259489.0",196,114,82,81,67,14,143,85,58,"6","2","2","1","1","5.0","1.0","2.0","1.0","1.0"
"jamui","bihar","Tola Mahasapathal","238.0","259490.0",769,411,358,465,292,173,255,178,77,"6","2","2","1","1","5.0","1.0","2.0","1.0","1.0"
"jamui","bihar","Tola Chahbachcha","238.0","259491.0",900,462,438,368,212,156,375,238,137,"4","1","1","1","1","5.0","1.0","2.0","1.0","1.0"
"jamui","bihar","Tola Nawadih","238.0","259492.0",1036,556,480,650,406,244,421,268,153,"7","1","2","3","1","5.0","1.0","2.0","1.0","1.0"
"jamui","bihar","Tola Dhorsakola","238.0","259493.0",362,189,173,192,121,71,110,102,8,"4","1","1","1","1","5.0","1.0","2.0","1.0","1.0"
"jamui","bihar","Tola Banarbhangua","238.0","259494.0",484,242,242,307,168,139,423,211,212,"5","1","2","1","1","5.0","1.0","2.0","1.0","1.0"
"jamui","bihar","Tola Chhirpathal","238.0","259495.0",823,450,373,527,323,204,329,205,124,"4","1","1","1","1","7.0","3.0","2.0","1.0","1.0"
"jamui","bihar","Tola Keluadih","238.0","259496.0",823,420,403,404,262,142,373,198,175,"5","1","2","1","1","5.0","1.0","2.0","1.0","1.0"
"jamui","bihar","Tola Berbari","238.0","259498.0",549,297,252,310,211,99,171,148,23,"4","1","1","1","1","5.0","1.0","2.0","1.0","1.0"
"jamui","bihar","Tola Mohalaya","238.0","259500.0",442,213,229,253,144,109,136,99,37,"5","1","2","1","1","5.0","1.0","2.0","1.0","1.0"
"jamui","bihar","Tola Chhata","238.0","259502.0",844,437,407,407,268,139,542,272,270,"4","1","1","1","1","5.0","1.0","2.0","1.0","1.0"
"jamui","bihar","Tola Gopidih","238.0","259503.0",148,73,75,83,49,34,41,39,2,"6","1","2","2","1","5.0","1.0","2.0","1.0","1.0"
"jamui","bihar","Tola Hariaindih","238.0","259505.0",880,451,429,400,269,131,290,226,64,"4","1","1","1","1","5.0","1.0","2.0","1.0","1.0"
"jamui","bihar","Tola Ghormo","238.0","259506.0",597,303,294,416,229,187,298,160,138,"5","1","2","1","1","5.0","1.0","2.0","1.0","1.0"
"jamui","bihar","Tola Karmatanr","238.0","259508.0",653,345,308,256,171,85,391,200,191,"4","1","1","1","1","5.0","1.0","2.0","1.0","1.0"
"jamui","bihar","Tola Darbedih","238.0","259509.0",199,104,95,62,36,26,103,59,44,"4","1","1","1","1","6.0","2.0","1.0","2.0","1.0"
"jamui","bihar","Tola Ramnidih","238.0","259510.0",222,105,117,64,31,33,51,51,0,"6","1","1","1","3","5.0","1.0","2.0","1.0","1.0"
"jamui","bihar","Tola Balagoji","238.0","259511.0",1844,955,889,822,521,301,543,477,66,"4","1","1","1","1","6.0","1.0","2.0","2.0","1.0"
"jamui","bihar","Tola Petarpahri","238.0","259512.0",1241,675,566,538,348,190,518,324,194,"7","1","2","3","1","5.0","2.0","1.0","1.0","1.0"
"jamui","bihar","Tola Nagri","238.0","259513.0",3449,1810,1639,2237,1306,931,1051,842,209,"7","1","2","3","1","6.0","1.0","2.0","2.0","1.0"
"jamui","bihar","Tola Lilodih","238.0","259514.0",526,285,241,355,204,151,132,131,1,"6","2","2","1","1","5.0","1.0","2.0","1.0","1.0"
"jamui","bihar","Tola Tinghara","238.0","259515.0",1071,562,509,625,378,247,451,274,177,"5","1","2","1","1","6.0","1.0","2.0","2.0","1.0"
"jamui","bihar","Tola Khas Chakai","238.0","259517.0",2911,1526,1385,1838,1068,770,949,721,228,"5","1","2","1","1","6.0","1.0","2.0","2.0","1.0"
"jamui","bihar","Tola Ramchandih","238.0","259518.0",1811,941,870,1090,646,444,361,230,131,"6","1","2","2","1","7.0","3.0","2.0","1.0","1.0"
"jamui","bihar","Tola Heth Chakai","238.0","259521.0",1961,1031,930,1163,698,465,563,507,56,"5","1","2","1","1","5.0","1.0","2.0","1.0","1.0"
"jamui","bihar","Tola Muswadih","238.0","259522.0",183,91,92,63,37,26,47,46,1,"4","1","1","1","1","5.0","1.0","2.0","1.0","1.0"
"jamui","bihar","Tola Ganespur","238.0","259523.0",662,369,293,356,225,131,231,182,49,"4","1","1","1","1","5.0","1.0","2.0","1.0","1.0"
"jamui","bihar","Tola Bagha","238.0","259524.0",819,421,398,448,269,179,431,218,213,"5","1","2","1","1","5.0","1.0","2.0","1.0","1.0"
"jamui","bihar","Tola Rajkarangarh","238.0","259660.0",1283,669,614,672,412,260,624,359,265,"4","1","1","1","1","5.0","1.0","2.0","1.0","1.0"
"jamui","bihar","Tola Muratanr","238.0","259662.0",77,45,32,57,34,23,64,37,27,"5","1","2","1","1","6.0","1.0","2.0","2.0","1.0"
"jamui","bihar","Tola Chophla","238.0","259663.0",964,498,466,521,328,193,573,310,263,"4","1","1","1","1","6.0","2.0","2.0","1.0","1.0"
"jamui","bihar","Tola Harla","238.0","259666.0",88,49,39,36,25,11,22,20,2,"6","3","1","1","1","5.0","1.0","2.0","1.0","1.0"
"jamui","bihar","Tola Bendra","238.0","259667.0",253,136,117,144,90,54,116,62,54,"4","1","1","1","1","4.0","1.0","1.0","1.0","1.0"
"jamui","bihar","Tola Baratanr","238.0","259668.0",157,78,79,57,36,21,63,54,9,"4","1","1","1","1","5.0","1.0","2.0","1.0","1.0"
"jamui","bihar","Tola Madadamgi","238.0","259669.0",63,26,37,36,18,18,24,14,10,"4","1","1","1","1","5.0","1.0","2.0","1.0","1.0"
"jamui","bihar","Tola Naukadih","238.0","259670.0",262,141,121,64,47,17,167,85,82,"4","1","1","1","1","5.0","1.0","2.0","1.0","1.0"
"jamui","bihar","Tola Thadhi","238.0","259672.0",730,394,336,285,196,89,523,286,237,"4","1","1","1","1","6.0","1.0","2.0","2.0","1.0"
"jamui","bihar","Tola Chhotkithadhi","238.0","259674.0",231,110,121,79,51,28,143,70,73,"4","1","1","1","1","5.0","1.0","2.0","1.0","1.0"
"jamui","bihar","Tola Gondalbari","238.0","259676.0",243,125,118,48,28,20,137,71,66,"4","1","1","1","1","4.0","1.0","1.0","1.0","1.0"
"jamui","bihar","Tola Kakoria","238.0","259678.0",667,365,302,195,140,55,357,193,164,"7","1","2","3","1","5.0","1.0","2.0","1.0","1.0"
"jamui","bihar","Tola Banadih","238.0","259680.0",237,152,85,115,78,37,108,75,33,"4","1","1","1","1","5.0","1.0","2.0","1.0","1.0"
"jamui","bihar","Tola Taraun","238.0","259684.0",193,106,87,74,51,23,90,52,38,"4","1","1","1","1","6.0","2.0","2.0","1.0","1.0"
"jamui","bihar","Tola Nauasair","238.0","259685.0",111,55,56,70,46,24,50,25,25,"6","1","1","3","1","5.0","1.0","2.0","1.0","1.0"
"jamui","bihar","Tola Charghara","238.0","259688.0",1382,742,640,415,278,137,776,449,327,"5","1","2","1","1","5.0","1.0","2.0","1.0","1.0"
"jamui","bihar","Tola Kitakasa","238.0","259691.0",89,45,44,24,15,9,51,25,26,"6","1","1","3","1","6.0","2.0","2.0","1.0","1.0"
"jamui","bihar","Tola Nontara","238.0","259693.0",407,201,206,153,97,56,326,161,165,"4","1","1","1","1","5.0","1.0","2.0","1.0","1.0"
"jamui","bihar","Tola Lachhmipur","238.0","259694.0",475,247,228,126,84,42,293,160,133,"5","2","1","1","1","5.0","1.0","2.0","1.0","1.0"
"jamui","bihar","Tola Kerwatanr","238.0","259695.0",242,124,118,85,49,36,138,67,71,"4","1","1","1","1","5.0","1.0","2.0","1.0","1.0"
"jamui","bihar","Tola Satpokhara","238.0","259696.0",300,155,145,134,91,43,151,79,72,"4","1","1","1","1","5.0","1.0","2.0","1.0","1.0"
"jamui","bihar","Tola Madhuri","238.0","259697.0",261,141,120,108,75,33,117,71,46,"4","1","1","1","1","5.0","1.0","2.0","1.0","1.0"
"jamui","bihar","Tola Kewal","238.0","259705.0",947,482,465,511,340,171,372,249,123,"5","1","2","1","1","5.0","1.0","2.0","1.0","1.0"
"jamui","bihar","Tola Dhamanian","238.0","259706.0",201,117,84,99,72,27,55,54,1,"6","1","2","2","1","6.0","1.0","2.0","2.0","1.0"
"jamui","bihar","Tola Tharhi","238.0","259707.0",625,331,294,263,186,77,209,174,35,"6","1","2","2","1","5.0","1.0","2.0","1.0","1.0"
"jamui","bihar","Tola Noniatari","238.0","259710.0",457,242,215,193,123,70,189,97,92,"8","2","2","3","1","5.0","1.0","2.0","1.0","1.0"
"jamui","bihar","Tola Bhandaro","238.0","259711.0",244,130,114,118,69,49,118,62,56,"5","1","2","1","1","5.0","1.0","2.0","1.0","1.0"
"jamui","bihar","Tola Baghwa","238.0","259712.0",917,489,428,437,296,141,637,334,303,"5","1","2","1","1","6.0","2.0","2.0","1.0","1.0"
"jamui","bihar","Tola Ambatanr","238.0","259713.0",230,124,106,73,53,20,124,63,61,"5","1","2","1","1","5.0","1.0","2.0","1.0","1.0"
"jamui","bihar","Ramsinghdih","238.0","259716.0",1185,608,577,541,366,175,332,314,18,"5","1","2","1","1","5.0","1.0","2.0","1.0","1.0"
"jamui","bihar","Tola Dhanoradih","238.0","259717.0",54,25,29,10,6,4,26,12,14,"6","1","2","2","1","5.0","1.0","2.0","1.0","1.0"
"jamui","bihar","Tola Laraitanr","238.0","259718.0",45,21,24,10,6,4,26,13,13,"6","1","2","2","1","6.0","1.0","2.0","2.0","1.0"
"jamui","bihar","Tola Naudiha","238.0","259720.0",473,255,218,159,107,52,269,145,124,"5","1","1","2","1","6.0","1.0","2.0","2.0","1.0"
"jamui","bihar","Tola Mohanpur","238.0","259721.0",78,39,39,27,20,7,18,16,2,"5","1","1","2","1","5.0","1.0","2.0","1.0","1.0"
"jamui","bihar","Tola Paharpur","238.0","259722.0",155,77,78,29,21,8,45,33,12,"5","1","2","1","1","6.0","1.0","2.0","2.0","1.0"
"jamui","bihar","Tola Karka","238.0","259723.0",13,6,7,4,3,1,6,5,1,"5","1","2","1","1","6.0","1.0","2.0","2.0","1.0"
"jamui","bihar","Tola Belatanr","238.0","259724.0",61,30,31,9,6,3,17,17,0,"5","1","2","1","1","5.0","1.0","2.0","1.0","1.0"
"jamui","bihar","Tola Ghatiani","238.0","259725.0",561,301,260,266,171,95,302,160,142,"5","1","1","2","1","5.0","1.0","2.0","1.0","1.0"
"jamui","bihar","Tola Bhaluari","238.0","259727.0",49,29,20,6,6,0,40,22,18,"5","1","1","2","1","5.0","1.0","2.0","1.0","1.0"
"jamui","bihar","Tola Ghutwe","238.0","259728.0",1959,1006,953,750,495,255,1090,548,542,"6","1","1","3","1","5.0","1.0","2.0","1.0","1.0"
"jamui","bihar","Tola Rupai","238.0","259729.0",388,200,188,77,59,18,108,96,12,"4","1","1","1","1","5.0","1.0","2.0","1.0","1.0"
"jamui","bihar","Tola Gadarjor","238.0","259730.0",193,96,97,59,37,22,57,51,6,"5","1","2","1","1","5.0","1.0","2.0","1.0","1.0"
"jamui","bihar","Tola Ambakol","238.0","259731.0",562,286,276,237,172,65,233,161,72,"5","1","1","2","1","7.0","1.0","2.0","3.0","1.0"
"jamui","bihar","Tola Dhanwegadi","238.0","259732.0",935,490,445,470,362,108,724,383,341,"6","1","2","2","1","5.0","1.0","1.0","2.0","1.0"
"jamui","bihar","Tola Sonaia","238.0","259733.0",380,219,161,172,126,46,224,114,110,"5","1","2","1","1","5.0","1.0","2.0","1.0","1.0"
"jamui","bihar","Tola Pachkathia","238.0","259736.0",294,151,143,98,76,22,180,88,92,"7","1","2","3","1","5.0","1.0","2.0","1.0","1.0"
"jamui","bihar","Tola Chunwaraidih","238.0","259737.0",611,317,294,277,187,90,307,159,148,"6","1","2","2","1","5.0","1.0","2.0","1.0","1.0"
"jamui","bihar","Tola Barakola","238.0","259741.0",155,77,78,63,42,21,67,35,32,"6","1","2","2","1","6.0","1.0","2.0","2.0","1.0"
"jamui","bihar","Tola Baghmara","238.0","259742.0",776,413,363,274,188,86,180,175,5,"5","1","1","2","1","7.0","1.0","2.0","3.0","1.0"
"jamui","bihar","Tola Rattidih","238.0","259743.0",109,52,57,64,37,27,52,26,26,"5","2","1","1","1","6.0","1.0","2.0","2.0","1.0"
"jamui","bihar","Tola Salaia","238.0","259745.0",174,81,93,75,51,24,95,49,46,"4","1","1","1","1","7.0","1.0","2.0","3.0","1.0"
"jamui","bihar","Tola Arapathal","238.0","259746.0",274,163,111,117,94,23,164,87,77,"4","1","1","1","1","5.0","1.0","2.0","1.0","1.0"
"jamui","bihar","Tola Bhunra","238.0","259747.0",580,311,269,238,178,60,336,168,168,"5","1","2","1","1","6.0","2.0","2.0","1.0","1.0"
"jamui","bihar","Tola karanka","238.0","259749.0",115,57,58,48,26,22,60,30,30,"5","1","1","1","2","5.0","1.0","2.0","1.0","1.0"
"jamui","bihar","Tola Bajpedih","238.0","259750.0",206,115,91,69,56,13,136,78,58,"4","1","1","1","1","5.0","1.0","2.0","1.0","1.0"
"jamui","bihar","Tola Babudih","238.0","259751.0",237,120,117,79,56,23,151,81,70,"4","1","1","1","1","7.0","2.0","2.0","2.0","1.0"
"jamui","bihar","Tola Asanghatia","238.0","259752.0",313,161,152,107,80,27,190,101,89,"4","1","1","1","1","5.0","1.0","2.0","1.0","1.0"
"jamui","bihar","Tola Basatpur","238.0","259753.0",240,133,107,126,88,38,123,66,57,"4","1","1","1","1","5.0","1.0","2.0","1.0","1.0"
"jamui","bihar","Tola Kaleyanpur","238.0","259756.0",1362,679,683,695,443,252,385,332,53,"4","1","1","1","1","6.0","1.0","2.0","2.0","1.0"
"jamui","bihar","Tola Jamuniatanr","238.0","259760.0",120,57,63,60,36,24,63,33,30,"5","1","1","2","1","5.0","1.0","2.0","1.0","1.0"
"jamui","bihar","Tola Gadipiarpher","238.0","259761.0",1065,519,546,450,287,163,553,303,250,"4","1","1","1","1","5.0","1.0","2.0","1.0","1.0"
"jamui","bihar","Tola Mohanpur","238.0","259765.0",247,125,122,151,86,65,140,73,67,"5","1","1","2","1","6.0","1.0","2.0","2.0","1.0"
"jamui","bihar","Tola Baro","238.0","259767.0",143,83,60,113,72,41,77,44,33,"5","1","2","1","1","5.0","1.0","2.0","1.0","1.0"
"jamui","bihar","Tola Khonadahar","238.0","259770.0",579,316,263,369,229,140,156,143,13,"4","1","1","1","1","6.0","1.0","2.0","2.0","1.0"
"jamui","bihar","Tola karna","238.0","259772.0",429,233,196,217,129,88,223,118,105,"4","1","1","1","1","5.0","1.0","2.0","1.0","1.0"
"jamui","bihar","Tola Nawadih","238.0","259776.0",944,524,420,538,334,204,411,262,149,"5","1","1","2","1","6.0","1.0","2.0","2.0","1.0"
"jamui","bihar","Tola Dadhwa","238.0","259778.0",639,345,294,240,157,83,266,149,117,"5","1","1","2","1","6.0","1.0","2.0","2.0","1.0"
"jamui","bihar","Tola Dudhanian","238.0","259779.0",1155,619,536,576,357,219,508,326,182,"6","1","2","2","1","5.0","1.0","2.0","1.0","1.0"
"jamui","bihar","Tola Tarbadia","238.0","259780.0",453,241,212,267,175,92,235,124,111,"5","1","1","2","1","6.0","1.0","2.0","2.0","1.0"
"jamui","bihar","Tola Bandha","238.0","259781.0",1375,717,658,588,383,205,641,329,312,"5","1","1","2","1","6.0","1.0","2.0","2.0","1.0"
"jamui","bihar","Tola Bhalua","238.0","259785.0",115,59,56,45,29,16,29,29,0,"5","1","1","2","1","6.0","1.0","2.0","2.0","1.0"
"jamui","bihar","Tola Lodhma","238.0","259789.0",338,179,159,118,93,25,138,89,49,"6","1","2","2","1","6.0","1.0","2.0","2.0","1.0"
"jamui","bihar","Tola Raichor","238.0","259790.0",574,303,271,279,185,94,147,121,26,"4","1","1","1","1","5.0","1.0","2.0","1.0","1.0"
"jamui","bihar","Tola Tharhi","238.0","259792.0",566,313,253,251,169,82,166,155,11,"6","1","2","2","1","5.0","1.0","2.0","1.0","1.0"
"jamui","bihar","Tola Baijudih","238.0","259927.0",227,121,106,62,38,24,64,62,2,"4","1","1","1","1","5.0","1.0","2.0","1.0","1.0"
"jamui","bihar","Tola Kailidih","238.0","259928.0",502,252,250,150,86,64,140,136,4,"5","1","2","1","1","5.0","1.0","2.0","1.0","1.0"
"jamui","bihar","Tola Sarsa","238.0","259929.0",251,131,120,94,64,30,132,67,65,"5","1","2","1","1","5.0","1.0","2.0","1.0","1.0"
"jamui","bihar","Tola Jogiatilha","238.0","259931.0",439,218,221,244,152,92,215,105,110,"5","1","2","1","1","5.0","1.0","2.0","1.0","1.0"
"jamui","bihar","Tola Kachuwa","238.0","259933.0",949,471,478,349,227,122,509,259,250,"4","1","1","1","1","4.0","1.0","1.0","1.0","1.0"
"jamui","bihar","Tola Behara","238.0","259934.0",931,469,462,365,250,115,471,284,187,"6","1","1","3","1","5.0","1.0","2.0","1.0","1.0"
"jamui","bihar","Tola Chehara","238.0","259935.0",416,213,203,204,140,64,271,141,130,"4","1","1","1","1","5.0","1.0","2.0","1.0","1.0"
"jamui","bihar","Tola Harni","238.0","259937.0",237,108,129,119,72,47,136,69,67,"5","2","1","1","1","5.0","1.0","2.0","1.0","1.0"
"jamui","bihar","Tola Siktia","238.0","259939.0",373,186,187,181,115,66,244,122,122,"5","2","1","1","1","5.0","1.0","2.0","1.0","1.0"
"jamui","bihar","Tola Barakol","238.0","259941.0",370,188,182,182,117,65,179,96,83,"5","2","1","1","1","4.0","1.0","1.0","1.0","1.0"
"jamui","bihar","Tola Rahima","238.0","259942.0",1015,519,496,416,293,123,515,258,257,"4","1","1","1","1","5.0","1.0","2.0","1.0","1.0"
"jamui","bihar","Tola Simaria","238.0","259943.0",1863,949,914,1172,719,453,404,349,55,"5","1","1","2","1","6.0","1.0","2.0","2.0","1.0"
"jamui","bihar","Tola Nanhia","238.0","259945.0",495,245,250,266,152,114,233,118,115,"5","2","1","1","1","5.0","1.0","2.0","1.0","1.0"
"jamui","bihar","Tola Khairsala","238.0","259946.0",67,32,35,30,19,11,32,16,16,"5","2","1","1","1","5.0","1.0","2.0","1.0","1.0"
"jamui","bihar","Tola Dhamna","238.0","259947.0",746,399,347,354,247,107,416,229,187,"4","1","1","1","1","5.0","1.0","2.0","1.0","1.0"
"jamui","bihar","Tola Pojha","238.0","259948.0",805,386,419,467,263,204,421,200,221,"5","1","2","1","1","5.0","1.0","2.0","1.0","1.0"
"jamui","bihar","Tola Mangatadih","238.0","259950.0",1439,766,673,926,533,393,573,403,170,"7","1","2","3","1","6.0","1.0","2.0","2.0","1.0"
"jamui","bihar","Tola Kepridih","238.0","259951.0",175,99,76,124,79,45,98,55,43,"5","1","2","1","1","6.0","1.0","2.0","2.0","1.0"
"jamui","bihar","Tola Bishunpur","238.0","259954.0",916,498,418,597,339,258,309,240,69,"5","1","2","1","1","5.0","1.0","2.0","1.0","1.0"
"jamui","bihar","Tola Chhichhudi","238.0","259955.0",715,395,320,381,251,130,208,199,9,"4","1","1","1","1","5.0","1.0","2.0","1.0","1.0"
"jamui","bihar","Tola Simaria Arazi","238.0","259956.0",376,202,174,204,143,61,160,108,52,"5","1","2","1","1","5.0","1.0","2.0","1.0","1.0"
"jamui","bihar","Tola Bela","238.0","259957.0",53,24,29,14,12,2,24,14,10,"5","1","2","1","1","5.0","1.0","2.0","1.0","1.0"
"jamui","bihar","Tola Nawada","238.0","259958.0",2564,1337,1227,1372,866,506,930,725,205,"7","1","2","3","1","5.0","1.0","2.0","1.0","1.0"
"jamui","bihar","Tola Badiadih","238.0","259959.0",226,115,111,158,92,66,96,60,36,"5","1","2","1","1","5.0","1.0","2.0","1.0","1.0"
"jamui","bihar","Tola Kalibank","238.0","259960.0",319,153,166,181,91,90,77,76,1,"4","1","1","1","1","5.0","1.0","2.0","1.0","1.0"
"jamui","bihar","Tola Garhi","238.0","259961.0",1025,533,492,524,327,197,396,259,137,"7","1","2","3","1","5.0","1.0","2.0","1.0","1.0"
"jamui","bihar","Tola Nawadih","238.0","259962.0",814,424,390,331,197,134,260,213,47,"4","1","1","1","1","4.0","1.0","1.0","1.0","1.0"
"jamui","bihar","Tola Diringi","238.0","259963.0",318,166,152,115,68,47,151,83,68,"6","1","2","2","1","5.0","1.0","2.0","1.0","1.0"
"jamui","bihar","Tola Nargi","238.0","259968.0",1748,904,844,849,545,304,676,446,230,"7","1","2","3","1","5.0","1.0","2.0","1.0","1.0"
"jamui","bihar","Tola Charghara","238.0","259969.0",900,461,439,262,190,72,371,205,166,"6","1","2","2","1","6.0","1.0","2.0","2.0","1.0"
"jamui","bihar","Tola Rajadumar","238.0","259972.0",270,137,133,107,73,34,143,80,63,"6","1","2","2","1","5.0","1.0","2.0","1.0","1.0"
"jamui","bihar","Tola Kusmha","238.0","259973.0",245,129,116,102,70,32,122,63,59,"5","1","1","2","1","5.0","1.0","2.0","1.0","1.0"
"jamui","bihar","Tola Sone","238.0","259974.0",501,258,243,194,134,60,382,192,190,"4","1","1","1","1","5.0","1.0","2.0","1.0","1.0"
"jamui","bihar","Tola Baljori","238.0","259977.0",473,254,219,172,114,58,271,139,132,"4","1","1","1","1","5.0","1.0","2.0","1.0","1.0"
"jamui","bihar","Tola Dhawatanr","238.0","259978.0",301,152,149,81,53,28,187,97,90,"4","1","1","1","1","5.0","1.0","2.0","1.0","1.0"
"jamui","bihar","Tola Kathwara","238.0","259979.0",1710,882,828,736,479,257,679,435,244,"5","1","1","2","1","7.0","1.0","2.0","3.0","1.0"
"jamui","bihar","Tola Jaruadih","238.0","259980.0",59,34,25,15,13,2,16,16,0,"6","1","2","2","1","5.0","1.0","2.0","1.0","1.0"
"jamui","bihar","Tola Moriadih","238.0","259981.0",885,461,424,493,329,164,476,245,231,"6","1","2","2","1","5.0","1.0","2.0","1.0","1.0"
"jamui","bihar","Tola Pungi","238.0","259982.0",251,122,129,150,94,56,111,74,37,"5","1","2","1","1","5.0","1.0","2.0","1.0","1.0"
"jamui","bihar","Tola Basbutti","238.0","259984.0",908,485,423,565,362,203,476,258,218,"6","1","2","2","1","5.0","1.0","2.0","1.0","1.0"
"jamui","bihar","Tola Marhi","238.0","259985.0",789,399,390,446,257,189,439,221,218,"7","1","2","3","1","5.0","1.0","2.0","1.0","1.0"
"jamui","bihar","Tola Belatanr","238.0","259986.0",473,242,231,263,150,113,270,142,128,"6","1","2","2","1","7.0","1.0","2.0","3.0","1.0"
"jamui","bihar","Tola Nawadih","238.0","259994.0",1263,658,605,753,452,301,471,343,128,"6","1","2","2","1","5.0","1.0","2.0","1.0","1.0"
"jamui","bihar","Tola Karjakol","238.0","259995.0",155,75,80,76,49,27,72,35,37,"5","1","2","1","1","5.0","1.0","2.0","1.0","1.0"
"jamui","bihar","Tola Basraha","238.0","259996.0",115,57,58,62,37,25,55,29,26,"4","1","1","1","1","5.0","1.0","2.0","1.0","1.0"
"jamui","bihar","Tola Mahtodih","238.0","259997.0",324,173,151,158,105,53,163,85,78,"5","1","2","1","1","5.0","1.0","2.0","1.0","1.0"
"jamui","bihar","Tola Thakursar","238.0","260000.0",221,121,100,107,84,23,135,73,62,"6","1","2","2","1","5.0","1.0","2.0","1.0","1.0"
"jamui","bihar","Tola Madhuwa","238.0","260002.0",28,14,14,19,12,7,13,7,6,"6","1","2","2","1","6.0","1.0","2.0","2.0","1.0"
"jamui","bihar","Tola Burhiatanr","238.0","260003.0",259,126,133,99,51,48,137,67,70,"5","1","2","1","1","5.0","1.0","2.0","1.0","1.0"
"jamui","bihar","Tola Gamharia","238.0","260010.0",721,376,345,332,222,110,203,197,6,"5","1","1","2","1","7.0","1.0","2.0","3.0","1.0"
"jamui","bihar","Tola Barhidih","238.0","260011.0",3,2,1,2,2,0,3,2,1,"6","1","2","2","1","6.0","1.0","2.0","2.0","1.0"
"jamui","bihar","Tola Gomdadih","238.0","260015.0",310,170,140,129,89,40,142,71,71,"6","1","2","2","1","5.0","1.0","2.0","1.0","1.0"
"jamui","bihar","Tola Siramandih","238.0","260016.0",958,501,457,506,310,196,552,294,258,"6","1","2","2","1","5.0","1.0","2.0","1.0","1.0"
"jamui","bihar","Tola Kathara","238.0","260017.0",572,290,282,317,202,115,218,154,64,"5","1","1","2","1","6.0","1.0","2.0","2.0","1.0"
"jamui","bihar","Tola Paranchi","238.0","260018.0",1339,708,631,499,339,160,483,374,109,"5","1","1","2","1","5.0","1.0","2.0","1.0","1.0"
"jamui","bihar","Tola Baradghatti","238.0","260023.0",443,242,201,183,128,55,216,111,105,"5","1","2","1","1","5.0","1.0","2.0","1.0","1.0"
"jamui","bihar","Markanwan","238.0","258581.0",2373,1213,1160,1183,674,509,872,544,328,"7","2","1","2","2","7.0","2.0","2.0","2.0","1.0"
"jamui","bihar","Bardih","238.0","258586.0",2136,1134,1002,1182,698,484,860,563,297,"7","2","2","2","1","7.0","2.0","2.0","2.0","1.0"
"jamui","bihar","Dighaut","238.0","258587.0",3843,1991,1852,1671,1040,631,1238,923,315,"6","2","1","2","1","7.0","2.0","2.0","2.0","1.0"
"jamui","bihar","Akauni Marthumbha","238.0","258588.0",1816,915,901,816,462,354,547,447,100,"7","2","2","2","1","7.0","2.0","2.0","2.0","1.0"
"jamui","bihar","Pachmahua","238.0","258594.0",1081,545,536,561,340,221,373,247,126,"7","1","2","3","1","6.0","2.0","2.0","1.0","1.0"
"jamui","bihar","Ramdih Chitauni","238.0","258595.0",1607,825,782,722,411,311,624,322,302,"7","2","2","2","1","7.0","2.0","2.0","2.0","1.0"
"jamui","bihar","Kumar","238.0","258597.0",5946,3085,2861,3421,2022,1399,2444,1617,827,"6","1","2","2","1","8.0","2.0","2.0","3.0","1.0"
"jamui","bihar","Dharampur","238.0","258598.0",1185,600,585,521,326,195,435,295,140,"7","2","2","2","1","7.0","2.0","2.0","2.0","1.0"
"jamui","bihar","Rewai","238.0","258599.0",3852,1945,1907,1636,986,650,1193,766,427,"7","2","2","2","1","7.0","2.0","2.0","2.0","1.0"
"jamui","bihar","Jagdispur","238.0","258602.0",1803,920,883,794,489,305,682,414,268,"5","2","1","1","1","6.0","2.0","2.0","1.0","1.0"
"jamui","bihar","Bahadurpur","238.0","258603.0",3197,1676,1521,1569,996,573,1175,828,347,"5","2","1","1","1","8.0","2.0","2.0","3.0","1.0"
"jamui","bihar","Sabal Bigha","238.0","258604.0",2891,1484,1407,1447,845,602,885,669,216,"8","2","2","1","3","7.0","2.0","2.0","2.0","1.0"
"jamui","bihar","Gokhula Fatehpur","238.0","258608.0",6109,3098,3011,2818,1785,1033,1833,1366,467,"7","2","2","2","1","7.0","2.0","2.0","2.0","1.0"
"jamui","bihar","Ramdeochak","238.0","258612.0",74,37,37,1,0,1,29,15,14,"5","2","1","1","1","7.0","2.0","2.0","2.0","1.0"
"jamui","bihar","Bhullo","238.0","258613.0",3579,1844,1735,1531,978,553,1383,845,538,"8","2","2","3","1","7.0","2.0","2.0","2.0","1.0"
"jamui","bihar","Sarsa","238.0","258614.0",761,402,359,424,272,152,305,195,110,"6","2","2","1","1","6.0","1.0","2.0","2.0","1.0"
"jamui","bihar","Bichhwa","238.0","258616.0",3035,1569,1466,1480,916,564,1698,920,778,"7","2","2","2","1","7.0","2.0","2.0","2.0","1.0"
"jamui","bihar","Kaithwara","238.0","258617.0",940,458,482,455,262,193,295,208,87,"5","1","1","2","1","7.0","2.0","2.0","2.0","1.0"
"jamui","bihar","Sikandra","238.0","258618.0",16805,8904,7901,10066,5908,4158,5495,4037,1458,"10","2","2","3","3","7.0","2.0","2.0","2.0","1.0"
"jamui","bihar","Karma","238.0","258619.0",1864,965,899,1005,602,403,526,400,126,"7","2","2","2","1","7.0","2.0","2.0","2.0","1.0"
"jamui","bihar","Silauri","238.0","258620.0",689,344,345,350,207,143,357,191,166,"6","2","1","2","1","7.0","2.0","2.0","2.0","1.0"
"jamui","bihar","Lohanda","238.0","258623.0",1671,892,779,984,555,429,770,438,332,"9","2","2","2","3","7.0","2.0","2.0","2.0","1.0"
"jamui","bihar","Manpur","238.0","258625.0",845,409,436,448,248,200,398,195,203,"7","2","1","3","1","7.0","2.0","2.0","2.0","1.0"
"jamui","bihar","Bhanta","238.0","258626.0",1048,563,485,478,290,188,414,258,156,"7","2","2","2","1","7.0","2.0","2.0","2.0","1.0"
"jamui","bihar","Tal Saharsa","238.0","258627.0",2590,1399,1191,1293,838,455,1196,675,521,"7","2","2","2","1","7.0","2.0","2.0","2.0","1.0"
"jamui","bihar","Jalai Dostni","238.0","258629.0",1557,810,747,739,458,281,839,438,401,"7","2","2","2","1","7.0","2.0","2.0","2.0","1.0"
"jamui","bihar","Gordih","238.0","258630.0",293,153,140,94,62,32,84,75,9,"8","2","2","3","1","7.0","2.0","2.0","2.0","1.0"
"jamui","bihar","Sijori","238.0","258631.0",5453,2816,2637,2623,1634,989,1956,1266,690,"7","2","2","2","1","7.0","2.0","2.0","2.0","1.0"
"jamui","bihar","Sardawad","238.0","258633.0",323,138,185,210,92,118,193,81,112,"7","2","2","2","1","7.0","2.0","2.0","2.0","1.0"
"jamui","bihar","Charan","238.0","258634.0",2504,1324,1180,1216,806,410,1023,572,451,"7","2","2","2","1","7.0","2.0","2.0","2.0","1.0"
"jamui","bihar","Ghos","238.0","258636.0",1412,726,686,565,361,204,469,352,117,"6","1","2","2","1","7.0","2.0","2.0","2.0","1.0"
"jamui","bihar","Majos","238.0","258637.0",4815,2470,2345,2252,1401,851,2340,1367,973,"6","1","2","2","1","7.0","2.0","2.0","2.0","1.0"
"jamui","bihar","Konan","238.0","258638.0",2579,1339,1240,1303,783,520,968,647,321,"8","2","2","3","1","7.0","2.0","2.0","2.0","1.0"
"jamui","bihar","Dhanwe","238.0","258640.0",2149,1138,1011,1227,739,488,1210,679,531,"7","1","2","3","1","7.0","2.0","2.0","2.0","1.0"
"jamui","bihar","Basaia","238.0","258641.0",1386,705,681,728,431,297,478,326,152,"7","1","2","3","1","7.0","2.0","2.0","2.0","1.0"
"jamui","bihar","Shiudih","238.0","258642.0",1819,911,908,771,473,298,881,454,427,"4","1","1","1","1","7.0","2.0","2.0","2.0","1.0"
"jamui","bihar","Raghunathpur","238.0","258645.0",1210,644,566,400,285,115,296,268,28,"5","2","1","1","1","7.0","2.0","2.0","2.0","1.0"
"jamui","bihar","Kenui","238.0","258646.0",621,324,297,358,230,128,307,161,146,"6","2","2","1","1","6.0","2.0","2.0","1.0","1.0"
"jamui","bihar","Patamar","238.0","258647.0",1911,1047,864,965,674,291,828,569,259,"6","2","2","1","1","7.0","2.0","2.0","2.0","1.0"
"jamui","bihar","Bohrama","238.0","258651.0",574,296,278,335,188,147,305,162,143,"6","2","2","1","1","8.0","2.0","2.0","3.0","1.0"
"jamui","bihar","Basbutti","238.0","258652.0",474,247,227,202,121,81,149,131,18,"5","2","1","1","1","6.0","2.0","2.0","1.0","1.0"
"jamui","bihar","Pakri","238.0","258653.0",1590,808,782,733,443,290,779,504,275,"5","2","1","1","1","7.0","2.0","2.0","2.0","1.0"
"jamui","bihar","Maricha","238.0","258655.0",5568,2894,2674,2421,1592,829,2721,1536,1185,"5","1","2","1","1","6.0","2.0","2.0","1.0","1.0"
"jamui","bihar","Daulatpur","238.0","258656.0",4661,2456,2205,2443,1493,950,1436,1120,316,"8","2","2","3","1","7.0","2.0","2.0","2.0","1.0"
"jamui","bihar","Maniadda","238.0","258657.0",2402,1220,1182,1297,785,512,778,578,200,"10","2","2","3","3","7.0","2.0","2.0","2.0","1.0"
"jamui","bihar","Garo Nawada","238.0","258659.0",1553,794,759,1117,610,507,533,362,171,"5","2","1","1","1","6.0","1.0","2.0","2.0","1.0"
"jamui","bihar","Lathane","238.0","258660.0",1976,1039,937,1008,665,343,752,451,301,"7","2","2","2","1","6.0","2.0","1.0","2.0","1.0"
"jamui","bihar","Sugi","238.0","258661.0",1506,792,714,778,523,255,248,192,56,"7","2","1","3","1","7.0","2.0","2.0","2.0","1.0"
"jamui","bihar","Thegua","238.0","258662.0",534,291,243,151,117,34,273,138,135,"6","2","1","2","1","7.0","2.0","2.0","2.0","1.0"
"jamui","bihar","Sonpai","238.0","258663.0",3442,1791,1651,1851,1139,712,907,844,63,"7","1","2","3","1","7.0","2.0","2.0","2.0","1.0"
"jamui","bihar","Garsanda","238.0","258664.0",4467,2306,2161,2300,1448,852,1998,1097,901,"7","2","2","2","1","7.0","2.0","2.0","2.0","1.0"
"jamui","bihar","Barar","238.0","258665.0",755,388,367,454,251,203,295,190,105,"9","2","2","2","3","7.0","2.0","2.0","2.0","1.0"
"jamui","bihar","Khargpur","238.0","258668.0",819,437,382,434,267,167,238,223,15,"6","2","1","2","1","7.0","2.0","2.0","2.0","1.0"
"jamui","bihar","Siho Chak","238.0","258670.0",446,235,211,267,149,118,109,97,12,"7","2","2","2","1","7.0","2.0","2.0","2.0","1.0"
"jamui","bihar","Agabara Barwata","238.0","258675.0",7063,3650,3413,3754,2284,1470,2427,1731,696,"7","2","2","2","1","7.0","2.0","2.0","2.0","1.0"
"jamui","bihar","Piri","238.0","258676.0",289,143,146,129,82,47,139,75,64,"5","1","1","2","1","7.0","2.0","2.0","2.0","1.0"
"jamui","bihar","Abhaipur","238.0","258677.0",1564,818,746,932,579,353,529,364,165,"7","2","2","2","1","7.0","2.0","2.0","2.0","1.0"
"jamui","bihar","Indpe","238.0","258680.0",2962,1548,1414,1668,1019,649,956,676,280,"7","2","2","2","1","6.0","2.0","2.0","1.0","1.0"
"jamui","bihar","Dhenkdih","238.0","258681.0",352,158,194,213,115,98,185,72,113,"7","2","2","2","1","7.0","2.0","2.0","2.0","1.0"
"jamui","bihar","Bukar","238.0","258682.0",3042,1573,1469,1555,948,607,1474,789,685,"7","2","2","2","1","7.0","2.0","2.0","2.0","1.0"
"jamui","bihar","Lotan","238.0","258683.0",932,493,439,346,208,138,270,154,116,"7","2","1","3","1","7.0","2.0","2.0","2.0","1.0"
"jamui","bihar","Narainpur","238.0","258684.0",2784,1397,1387,1667,1006,661,925,704,221,"8","2","2","3","1","7.0","2.0","2.0","2.0","1.0"
"jamui","bihar","Bijuahi","238.0","258685.0",757,394,363,564,324,240,196,182,14,"7","2","2","2","1","6.0","2.0","2.0","1.0","1.0"
"jamui","bihar","Majhwe","238.0","258686.0",5225,2699,2526,2078,1265,813,1699,1186,513,"6","1","2","2","1","7.0","2.0","2.0","2.0","1.0"
"jamui","bihar","Lakhan Dhanawan","238.0","258689.0",1461,731,730,592,367,225,488,330,158,"6","2","1","2","1","7.0","2.0","2.0","2.0","1.0"
"jamui","bihar","Domanpura","238.0","258690.0",1761,927,834,685,436,249,822,453,369,"8","2","2","3","1","7.0","2.0","2.0","2.0","1.0"
"jamui","bihar","Nabinagar","238.0","258691.0",4250,2296,1954,2295,1400,895,1714,1118,596,"7","1","2","3","1","7.0","2.0","2.0","2.0","1.0"
"jamui","bihar","Lakhapur","238.0","258692.0",2483,1274,1209,1037,635,402,773,647,126,"7","2","2","2","1","7.0","2.0","2.0","2.0","1.0"
"jamui","bihar","Kakan","238.0","258693.0",7121,3648,3473,3227,1919,1308,2798,1728,1070,"7","2","2","2","1","7.0","2.0","2.0","2.0","1.0"
"jamui","bihar","Sonai","238.0","258694.0",2288,1203,1085,1016,590,426,865,513,352,"5","1","1","2","1","7.0","2.0","2.0","2.0","1.0"
"jamui","bihar","Dhandh","238.0","258695.0",2272,1207,1065,1237,767,470,696,472,224,"6","2","1","2","1","6.0","2.0","2.0","1.0","1.0"
"jamui","bihar","Lakhanpur","238.0","258696.0",2371,1279,1092,1423,915,508,761,568,193,"6","2","1","2","1","7.0","2.0","2.0","2.0","1.0"
"jamui","bihar","Partapur","238.0","258697.0",1786,955,831,944,576,368,525,440,85,"8","2","2","3","1","7.0","2.0","2.0","2.0","1.0"
"jamui","bihar","Rajpura","238.0","258698.0",815,430,385,301,199,102,231,187,44,"5","2","1","1","1","5.0","1.0","2.0","1.0","1.0"
"jamui","bihar","Marwa","238.0","258699.0",1817,929,888,691,425,266,588,410,178,"5","2","1","1","1","7.0","2.0","2.0","2.0","1.0"
"jamui","bihar","Dighoi","238.0","258700.0",681,364,317,325,211,114,168,167,1,"7","2","2","2","1","7.0","2.0","2.0","2.0","1.0"
"jamui","bihar","Semaria Bikrampur","238.0","258701.0",1188,631,557,618,419,199,534,288,246,"7","2","2","2","1","7.0","2.0","2.0","2.0","1.0"
"jamui","bihar","Amma Sarari","238.0","258702.0",3631,1893,1738,1918,1139,779,1487,842,645,"7","2","2","2","1","7.0","2.0","2.0","2.0","1.0"
"jamui","bihar","Misir Manda","238.0","258703.0",757,397,360,402,235,167,387,195,192,"6","2","1","2","1","7.0","2.0","2.0","2.0","1.0"
"jamui","bihar","Nim Nawada","238.0","258704.0",1305,659,646,636,378,258,405,253,152,"6","2","1","2","1","7.0","2.0","2.0","2.0","1.0"
"jamui","bihar","Bhat Chak","238.0","258705.0",1459,756,703,839,518,321,537,346,191,"6","2","1","2","1","7.0","2.0","2.0","2.0","1.0"
"jamui","bihar","Damdama","238.0","258706.0",152,80,72,71,50,21,75,37,38,"6","2","1","2","1","7.0","2.0","2.0","2.0","1.0"
"jamui","bihar","Sira Nawada","238.0","258707.0",735,382,353,202,114,88,232,193,39,"8","3","2","2","1","7.0","2.0","2.0","2.0","1.0"
"jamui","bihar","Lohra","238.0","258709.0",5140,2636,2504,2633,1602,1031,1816,1201,615,"7","2","2","2","1","7.0","2.0","2.0","2.0","1.0"
"jamui","bihar","Sultanpur","238.0","258711.0",304,168,136,77,62,15,260,145,115,"5","1","1","2","1","7.0","2.0","2.0","2.0","1.0"
"jamui","bihar","Amrath","238.0","258712.0",7175,3693,3482,3321,2009,1312,2356,1713,643,"7","2","2","2","1","7.0","2.0","2.0","2.0","1.0"
"jamui","bihar","Sangthu","238.0","258715.0",3806,1970,1836,2102,1196,906,1720,1055,665,"7","2","2","2","1","7.0","2.0","2.0","2.0","1.0"
"jamui","bihar","Bhagwana","238.0","258717.0",1328,691,637,619,434,185,576,340,236,"7","2","2","2","1","7.0","2.0","2.0","2.0","1.0"
"jamui","bihar","Kundri Son Kurha Harla","238.0","258719.0",5734,2918,2816,3226,1846,1380,2495,1504,991,"7","2","2","2","1","7.0","2.0","2.0","2.0","1.0"
"jamui","bihar","Chandwara","238.0","258720.0",1357,724,633,870,499,371,497,358,139,"7","2","2","2","1","7.0","2.0","2.0","2.0","1.0"
"jamui","bihar","Kharsari","238.0","258721.0",4725,2441,2284,2490,1333,1157,2100,1249,851,"6","2","1","2","1","7.0","2.0","2.0","2.0","1.0"
