"district","state","location_name","dist_code_2011","vill_code_2011","tot_p","tot_m","tot_f","p_lit","m_lit","f_lit","tot_work_p","tot_work_m","tot_work_f","adi_2011","msw_2011","asset_2011","fc_2011","bf_2011","adi_2019","msw_2019","asset_2019","fc_2019","bf_2019"
"ranchi","jharkhand","Sarle","364.0","373367.0",2011,1007,1004,1006,609,397,619,457,162,"5","1","1","1","2","6.0","1.0","3.0","1.0","1.0"
"ranchi","jharkhand","Saram","364.0","373401.0",1306,682,624,665,409,256,624,316,308,"4","1","1","1","1","5.0","1.0","2.0","1.0","1.0"
"ranchi","jharkhand","Usku","364.0","373402.0",975,495,480,365,212,153,488,246,242,"4","1","1","1","1","5.0","1.0","2.0","1.0","1.0"
"ranchi","jharkhand","Patkai","364.0","373403.0",648,316,332,370,205,165,302,159,143,"5","1","2","1","1","6.0","1.0","3.0","1.0","1.0"
"ranchi","jharkhand","Kaskoma","364.0","373404.0",154,81,73,66,39,27,63,33,30,"5","2","1","1","1","6.0","1.0","3.0","1.0","1.0"
"ranchi","jharkhand","Murgi","364.0","373405.0",1142,582,560,595,348,247,553,271,282,"6","2","2","1","1","6.0","1.0","3.0","1.0","1.0"
"ranchi","jharkhand","Chanya","364.0","373406.0",533,266,267,236,132,104,172,90,82,"4","1","1","1","1","6.0","1.0","3.0","1.0","1.0"
"ranchi","jharkhand","Piraguttu","364.0","373407.0",518,270,248,248,147,101,247,126,121,"4","1","1","1","1","7.0","3.0","2.0","1.0","1.0"
"ranchi","jharkhand","Bangaon","364.0","373408.0",679,336,343,356,201,155,401,196,205,"4","1","1","1","1","6.0","1.0","3.0","1.0","1.0"
"ranchi","jharkhand","Hatnai","364.0","373409.0",213,109,104,103,64,39,137,67,70,"4","1","1","1","1","5.0","1.0","2.0","1.0","1.0"
"ranchi","jharkhand","Murwe","364.0","373410.0",645,319,326,318,177,141,235,167,68,"4","1","1","1","1","6.0","1.0","3.0","1.0","1.0"
"ranchi","jharkhand","Kotari","364.0","373411.0",843,432,411,450,255,195,310,193,117,"4","1","1","1","1","5.0","1.0","2.0","1.0","1.0"
"ranchi","jharkhand","Burmu","364.0","373412.0",3661,1867,1794,1888,1114,774,1794,1010,784,"6","2","2","1","1","6.0","1.0","3.0","1.0","1.0"
"ranchi","jharkhand","Ara","364.0","373413.0",278,127,151,189,97,92,117,58,59,"6","2","2","1","1","5.0","1.0","2.0","1.0","1.0"
"ranchi","jharkhand","Chakme","364.0","373414.0",3023,1540,1483,1880,1065,815,1214,721,493,"5","1","2","1","1","6.0","1.0","3.0","1.0","1.0"
"ranchi","jharkhand","Rol","364.0","373415.0",1004,521,483,552,337,215,571,303,268,"4","1","1","1","1","5.0","1.0","2.0","1.0","1.0"
"ranchi","jharkhand","Matwe","364.0","373416.0",1854,938,916,1079,639,440,481,464,17,"4","1","1","1","1","5.0","1.0","2.0","1.0","1.0"
"ranchi","jharkhand","Gutru","364.0","373417.0",551,273,278,352,200,152,277,131,146,"4","1","1","1","1","5.0","1.0","2.0","1.0","1.0"
"ranchi","jharkhand","Geswe","364.0","373418.0",1785,898,887,957,567,390,762,445,317,"7","1","2","3","1","6.0","1.0","3.0","1.0","1.0"
"ranchi","jharkhand","Surid","364.0","373419.0",465,223,242,278,156,122,221,113,108,"4","1","1","1","1","5.0","1.0","2.0","1.0","1.0"
"ranchi","jharkhand","Katangdiri","364.0","373420.0",989,498,491,646,369,277,458,271,187,"4","1","1","1","1","5.0","1.0","2.0","1.0","1.0"
"ranchi","jharkhand","Hesalpiri","364.0","373421.0",1760,906,854,888,548,340,805,437,368,"5","1","2","1","1","5.0","1.0","2.0","1.0","1.0"
"ranchi","jharkhand","Korabar","364.0","373422.0",873,429,444,510,296,214,476,236,240,"4","1","1","1","1","5.0","1.0","2.0","1.0","1.0"
"ranchi","jharkhand","Turmuli","364.0","373423.0",652,311,341,367,207,160,229,159,70,"5","2","1","1","1","5.0","1.0","2.0","1.0","1.0"
"ranchi","jharkhand","Manatu","364.0","373424.0",985,499,486,512,292,220,471,256,215,"5","1","2","1","1","7.0","1.0","2.0","1.0","3.0"
"ranchi","jharkhand","Bare","364.0","373425.0",1525,770,755,868,509,359,793,436,357,"4","1","1","1","1","4.0","1.0","1.0","1.0","1.0"
"ranchi","jharkhand","Sidraul","364.0","373426.0",1706,791,915,1155,560,595,717,364,353,"5","2","1","1","1","5.0","1.0","2.0","1.0","1.0"
"ranchi","jharkhand","Nauj","364.0","373427.0",1325,653,672,753,396,357,588,348,240,"7","1","2","1","3","5.0","1.0","2.0","1.0","1.0"
"ranchi","jharkhand","Kulwe","364.0","373428.0",348,183,165,198,119,79,107,92,15,"5","1","2","1","1","10.0","1.0","3.0","3.0","3.0"
"ranchi","jharkhand","Berwari","364.0","373429.0",638,322,316,398,246,152,358,187,171,"6","2","2","1","1","4.0","1.0","1.0","1.0","1.0"
"ranchi","jharkhand","Soba","364.0","373430.0",854,414,440,518,293,225,454,254,200,"7","2","1","1","3","6.0","1.0","3.0","1.0","1.0"
"ranchi","jharkhand","Ginjothakurgaon","364.0","373431.0",5862,3081,2781,3741,2220,1521,2136,1545,591,"8","2","2","3","1","5.0","1.0","2.0","1.0","1.0"
"ranchi","jharkhand","Dandiya","364.0","373432.0",1550,797,753,814,462,352,710,447,263,"5","1","2","1","1","5.0","1.0","2.0","1.0","1.0"
"ranchi","jharkhand","Gurgain","364.0","373433.0",3008,1512,1496,1656,947,709,1342,786,556,"4","1","1","1","1","5.0","1.0","2.0","1.0","1.0"
"ranchi","jharkhand","Arra (Arara)","364.0","373434.0",422,209,213,217,126,91,209,109,100,"5","1","2","1","1","5.0","1.0","2.0","1.0","1.0"
"ranchi","jharkhand","Murumgara","364.0","373435.0",1178,578,600,615,362,253,516,297,219,"4","1","1","1","1","5.0","1.0","2.0","1.0","1.0"
"ranchi","jharkhand","Ithe","364.0","373436.0",951,496,455,504,296,208,401,246,155,"8","2","2","3","1","5.0","1.0","2.0","1.0","1.0"
"ranchi","jharkhand","Hisri","364.0","373438.0",1596,799,797,932,530,402,1077,544,533,"4","1","1","1","1","5.0","1.0","2.0","1.0","1.0"
"ranchi","jharkhand","Basri (Banoari)","364.0","373439.0",927,505,422,534,334,200,417,244,173,"5","1","2","1","1","5.0","1.0","2.0","1.0","1.0"
"ranchi","jharkhand","Bhantboreya","364.0","373440.0",573,289,284,320,185,135,311,176,135,"6","2","2","1","1","5.0","1.0","2.0","1.0","1.0"
"ranchi","jharkhand","Baraudi","364.0","373441.0",1620,822,798,960,575,385,725,475,250,"6","1","3","1","1","5.0","1.0","2.0","1.0","1.0"
"ranchi","jharkhand","Kewtia","364.0","373442.0",404,210,194,186,111,75,132,90,42,"5","1","2","1","1","5.0","1.0","2.0","1.0","1.0"
"ranchi","jharkhand","Khakhra","364.0","373443.0",2024,1035,989,1007,613,394,1146,604,542,"6","2","2","1","1","5.0","1.0","2.0","1.0","1.0"
"ranchi","jharkhand","Lapra","364.0","373444.0",3559,1846,1713,1885,1109,776,999,797,202,"7","1","2","3","1","5.0","1.0","2.0","1.0","1.0"
"ranchi","jharkhand","Hesalang","364.0","373445.0",2505,1274,1231,1404,793,611,983,623,360,"6","1","2","2","1","5.0","1.0","2.0","1.0","1.0"
"ranchi","jharkhand","Mahuliya","364.0","373446.0",51,26,25,23,14,9,15,15,0,"4","1","1","1","1","5.0","1.0","2.0","1.0","1.0"
"ranchi","jharkhand","Nawadih","364.0","373447.0",1594,798,796,728,459,269,423,353,70,"7","1","2","3","1","7.0","3.0","2.0","1.0","1.0"
"ranchi","jharkhand","Tumang","364.0","373448.0",4678,2460,2218,3354,1947,1407,1086,966,120,"10","1","3","3","3","7.0","3.0","2.0","1.0","1.0"
"ranchi","jharkhand","Mayapur","364.0","373449.0",1761,920,841,926,547,379,613,397,216,"4","1","1","1","1","5.0","1.0","2.0","1.0","1.0"
"ranchi","jharkhand","Konka","364.0","373450.0",1540,772,768,888,494,394,557,363,194,"7","1","2","3","1","5.0","1.0","2.0","1.0","1.0"
"ranchi","jharkhand","Harhu","364.0","373451.0",515,247,268,289,156,133,140,130,10,"4","1","1","1","1","5.0","1.0","2.0","1.0","1.0"
"ranchi","jharkhand","Duli","364.0","373452.0",573,289,284,249,136,113,305,154,151,"4","1","1","1","1","6.0","2.0","2.0","1.0","1.0"
"ranchi","jharkhand","Kedal","364.0","373453.0",411,211,200,168,104,64,112,100,12,"4","1","1","1","1","5.0","1.0","2.0","1.0","1.0"
"ranchi","jharkhand","Hoyar","364.0","373454.0",1842,920,922,850,496,354,644,440,204,"7","1","2","3","1","5.0","1.0","2.0","1.0","1.0"
"ranchi","jharkhand","Dondu","364.0","373455.0",1023,509,514,527,302,225,346,246,100,"7","2","2","2","1","5.0","1.0","2.0","1.0","1.0"
"ranchi","jharkhand","Babhne (Bamne)","364.0","373456.0",1457,758,699,732,444,288,544,341,203,"6","1","2","2","1","5.0","1.0","2.0","1.0","1.0"
"ranchi","jharkhand","Manatu","364.0","373457.0",360,179,181,185,110,75,113,87,26,"5","1","2","1","1","6.0","1.0","3.0","1.0","1.0"
"ranchi","jharkhand","Bagda","364.0","373462.0",692,359,333,344,217,127,340,184,156,"5","2","1","1","1","5.0","1.0","2.0","1.0","1.0"
"ranchi","jharkhand","Benti","364.0","373463.0",703,358,345,218,148,70,342,182,160,"5","1","2","1","1","5.0","1.0","2.0","1.0","1.0"
"ranchi","jharkhand","Menrhi","364.0","373464.0",470,253,217,255,159,96,259,143,116,"4","1","1","1","1","5.0","1.0","2.0","1.0","1.0"
"ranchi","jharkhand","Muretha","364.0","373465.0",691,332,359,208,123,85,387,207,180,"4","1","1","1","1","5.0","1.0","2.0","1.0","1.0"
"ranchi","jharkhand","Okhargara","364.0","373467.0",1313,672,641,658,405,253,464,329,135,"4","1","1","1","1","6.0","1.0","3.0","1.0","1.0"
"ranchi","jharkhand","Madanpur","364.0","373468.0",1037,535,502,568,336,232,331,254,77,"5","1","2","1","1","5.0","1.0","2.0","1.0","1.0"
"ranchi","jharkhand","Sutiambe","364.0","373469.0",1819,951,868,1046,655,391,697,452,245,"5","1","2","1","1","5.0","1.0","2.0","1.0","1.0"
"ranchi","jharkhand","Pithauriya","364.0","373470.0",6550,3413,3137,4393,2556,1837,2104,1632,472,"10","1","3","3","3","5.0","1.0","2.0","1.0","1.0"
"ranchi","jharkhand","Pusu","364.0","373471.0",888,441,447,438,260,178,249,210,39,"4","1","1","1","1","6.0","1.0","3.0","1.0","1.0"
"ranchi","jharkhand","Chirua","364.0","373472.0",418,208,210,197,110,87,182,92,90,"4","1","1","1","1","5.0","1.0","2.0","1.0","1.0"
"ranchi","jharkhand","Patratu","364.0","373473.0",994,503,491,454,268,186,464,239,225,"4","1","1","1","1","5.0","1.0","2.0","1.0","1.0"
"ranchi","jharkhand","Uruguttu","364.0","373474.0",3715,1890,1825,2126,1288,838,1477,900,577,"6","2","2","1","1","5.0","1.0","2.0","1.0","1.0"
"ranchi","jharkhand","Marwa","364.0","373475.0",1274,633,641,774,449,325,668,326,342,"5","1","2","1","1","6.0","1.0","3.0","1.0","1.0"
"ranchi","jharkhand","Katamkuli","364.0","373476.0",5903,3000,2903,3647,2112,1535,1842,1451,391,"5","1","2","1","1","6.0","1.0","3.0","1.0","1.0"
"ranchi","jharkhand","Malsiring","364.0","373477.0",2203,1126,1077,1341,804,537,923,539,384,"5","1","2","1","1","5.0","1.0","2.0","1.0","1.0"
"ranchi","jharkhand","Sirango","364.0","373478.0",1542,738,804,941,522,419,716,407,309,"4","1","1","1","1","5.0","1.0","2.0","1.0","1.0"
"ranchi","jharkhand","Manha","364.0","373479.0",595,300,295,350,216,134,191,144,47,"4","1","1","1","1","6.0","1.0","3.0","1.0","1.0"
"ranchi","jharkhand","Karkata","364.0","373480.0",1695,871,824,974,577,397,777,487,290,"6","2","2","1","1","5.0","1.0","2.0","1.0","1.0"
"ranchi","jharkhand","Jidu","364.0","373481.0",508,203,305,252,130,122,265,123,142,"6","2","2","1","1","5.0","1.0","2.0","1.0","1.0"
"ranchi","jharkhand","Uparkonki","364.0","373482.0",1788,937,851,1103,676,427,474,364,110,"5","1","2","1","1","6.0","1.0","3.0","1.0","1.0"
"ranchi","jharkhand","Hethkonki","364.0","373483.0",2183,1099,1084,1229,720,509,804,528,276,"6","2","2","1","1","5.0","1.0","2.0","1.0","1.0"
"ranchi","jharkhand","Ichapiri","364.0","373484.0",4241,2209,2032,2675,1581,1094,1909,1116,793,"5","1","2","1","1","5.0","1.0","2.0","1.0","1.0"
"ranchi","jharkhand","Nawadih","364.0","373485.0",1040,515,525,542,301,241,254,234,20,"6","1","1","3","1","5.0","1.0","2.0","1.0","1.0"
"ranchi","jharkhand","Barhu","364.0","373486.0",3529,1800,1729,2010,1193,817,1089,839,250,"8","2","2","3","1","4.0","1.0","1.0","1.0","1.0"
"ranchi","jharkhand","Jamuari","364.0","373487.0",164,93,71,120,70,50,50,38,12,"5","1","2","1","1","5.0","1.0","2.0","1.0","1.0"
"ranchi","jharkhand","Kokdaro","364.0","373488.0",2422,1222,1200,1400,812,588,742,539,203,"6","1","2","2","1","5.0","1.0","2.0","1.0","1.0"
"ranchi","jharkhand","Khatanga","364.0","373489.0",788,417,371,428,261,167,229,183,46,"6","2","2","1","1","5.0","1.0","2.0","1.0","1.0"
"ranchi","jharkhand","Balu","364.0","373490.0",1100,578,522,774,452,322,603,314,289,"5","1","2","1","1","5.0","1.0","2.0","1.0","1.0"
"ranchi","jharkhand","Chitar","364.0","373491.0",712,368,344,296,173,123,190,145,45,"4","1","1","1","1","5.0","1.0","2.0","1.0","1.0"
"ranchi","jharkhand","Sadkanadu","364.0","373492.0",1913,1008,905,960,596,364,670,400,270,"7","1","2","3","1","5.0","1.0","2.0","1.0","1.0"
"ranchi","jharkhand","Kalheyakanadu","364.0","373493.0",885,456,429,459,275,184,357,219,138,"5","2","1","1","1","7.0","2.0","3.0","1.0","1.0"
"ranchi","jharkhand","Batta","364.0","373494.0",1065,533,532,564,316,248,422,257,165,"5","1","2","1","1","5.0","1.0","2.0","1.0","1.0"
"ranchi","jharkhand","Kumhariya","364.0","373495.0",1785,908,877,895,525,370,624,441,183,"4","1","1","1","1","6.0","1.0","3.0","1.0","1.0"
"ranchi","jharkhand","Chardi","364.0","373496.0",1298,631,667,739,440,299,416,334,82,"5","1","2","1","1","5.0","1.0","2.0","1.0","1.0"
"ranchi","jharkhand","Chauli","364.0","373497.0",796,410,386,370,219,151,212,192,20,"8","2","2","3","1","6.0","1.0","3.0","1.0","1.0"
"ranchi","jharkhand","Ulatu","364.0","373498.0",1392,717,675,642,375,267,361,332,29,"8","2","2","3","1","5.0","1.0","2.0","1.0","1.0"
"ranchi","jharkhand","Soso","364.0","373499.0",1035,539,496,565,333,232,356,233,123,"4","1","1","1","1","6.0","1.0","3.0","1.0","1.0"
"ranchi","jharkhand","Siddi","364.0","373500.0",488,238,250,290,169,121,132,115,17,"4","1","1","1","1","6.0","1.0","3.0","1.0","1.0"
"ranchi","jharkhand","Gobarhappa","364.0","373501.0",630,313,317,334,200,134,145,134,11,"4","1","1","1","1","5.0","1.0","2.0","1.0","1.0"
"ranchi","jharkhand","Hundur","364.0","373502.0",2303,1150,1153,1108,651,457,1064,616,448,"6","1","1","3","1","5.0","1.0","2.0","1.0","1.0"
"ranchi","jharkhand","Chari","364.0","373503.0",774,383,391,343,209,134,295,199,96,"7","1","2","3","1","5.0","1.0","2.0","1.0","1.0"
"ranchi","jharkhand","Haldama","364.0","373504.0",498,253,245,267,155,112,276,145,131,"5","1","2","1","1","5.0","1.0","2.0","1.0","1.0"
"ranchi","jharkhand","Hujir","364.0","373505.0",1017,481,536,583,339,244,528,259,269,"8","1","3","3","1","5.0","1.0","2.0","1.0","1.0"
"ranchi","jharkhand","Neuri","364.0","373506.0",6907,3700,3207,4419,2754,1665,1938,1545,393,"9","1","3","2","3","4.0","1.0","1.0","1.0","1.0"
"ranchi","jharkhand","Oyna","364.0","373507.0",1372,716,656,679,414,265,664,340,324,"8","2","2","3","1","4.0","1.0","1.0","1.0","1.0"
"ranchi","jharkhand","Chandewe","364.0","373508.0",3377,1745,1632,1879,1124,755,1149,820,329,"8","1","3","1","3","5.0","1.0","2.0","1.0","1.0"
"ranchi","jharkhand","Dubliya Alias Dugliya","364.0","373509.0",1490,778,712,845,503,342,778,381,397,"5","1","2","1","1","6.0","1.0","3.0","1.0","1.0"
"ranchi","jharkhand","Banhara","364.0","373510.0",1086,529,557,597,334,263,484,262,222,"5","1","2","1","1","5.0","1.0","2.0","1.0","1.0"
"ranchi","jharkhand","Murum","364.0","373511.0",1099,543,556,615,361,254,322,286,36,"4","1","1","1","1","5.0","1.0","2.0","1.0","1.0"
"ranchi","jharkhand","Ral","364.0","373512.0",568,295,273,338,202,136,229,133,96,"6","1","3","1","1","5.0","1.0","2.0","1.0","1.0"
"ranchi","jharkhand","Bukru","364.0","373515.0",1228,626,602,861,472,389,371,320,51,"10","1","3","3","3","7.0","1.0","2.0","3.0","1.0"
"ranchi","jharkhand","Chama","364.0","373516.0",1065,534,531,513,313,200,511,294,217,"5","1","2","1","1","5.0","1.0","2.0","1.0","1.0"
"ranchi","jharkhand","Patagain","364.0","373517.0",859,425,434,434,254,180,406,227,179,"5","1","2","1","1","5.0","1.0","2.0","1.0","1.0"
"ranchi","jharkhand","Gagi","364.0","373518.0",3026,1510,1516,1821,1044,777,1039,696,343,"7","1","2","3","1","5.0","1.0","2.0","1.0","1.0"
"ranchi","jharkhand","Khatanga","364.0","373519.0",1502,727,775,910,502,408,370,316,54,"5","1","2","1","1","5.0","1.0","2.0","1.0","1.0"
"ranchi","jharkhand","Chamguru","364.0","373520.0",2155,1061,1094,1013,591,422,935,546,389,"5","1","1","2","1","5.0","1.0","2.0","1.0","1.0"
"ranchi","jharkhand","Sanga","364.0","373521.0",1774,903,871,864,512,352,758,465,293,"6","1","1","3","1","5.0","1.0","2.0","1.0","1.0"
"ranchi","jharkhand","Cheri","364.0","373522.0",1469,729,740,751,458,293,624,368,256,"6","1","2","2","1","4.0","1.0","1.0","1.0","1.0"
"ranchi","jharkhand","Manatu","364.0","373523.0",2585,1274,1311,1422,839,583,893,625,268,"6","1","2","2","1","5.0","1.0","2.0","1.0","1.0"
"ranchi","jharkhand","Tendar","364.0","373524.0",2006,1125,881,1034,721,313,900,689,211,"5","1","2","1","1","5.0","1.0","2.0","1.0","1.0"
"ranchi","jharkhand","Pirra","364.0","373525.0",1884,962,922,1315,735,580,563,444,119,"10","1","3","3","3","5.0","1.0","2.0","1.0","1.0"
"ranchi","jharkhand","Tilta","364.0","373526.0",1839,921,918,968,530,438,492,377,115,"6","2","2","1","1","6.0","1.0","3.0","1.0","1.0"
"ranchi","jharkhand","Dandaiphutkal Toli","364.0","373527.0",2294,1160,1134,1415,795,620,361,325,36,"8","2","2","1","3","6.0","1.0","3.0","1.0","1.0"
"ranchi","jharkhand","Simliya","364.0","373528.0",6523,3311,3212,4008,2305,1703,2197,1563,634,"9","2","3","3","1","7.0","1.0","2.0","3.0","1.0"
"ranchi","jharkhand","Dahisot","364.0","373532.0",1438,724,714,861,503,358,665,356,309,"6","1","1","3","1","5.0","1.0","2.0","1.0","1.0"
"ranchi","jharkhand","Kamre","364.0","373533.0",6114,3292,2822,4533,2603,1930,1627,1293,334,"11","2","3","3","3","5.0","1.0","2.0","1.0","1.0"
"ranchi","jharkhand","Jhiri","364.0","373534.0",3486,1813,1673,2290,1317,973,1034,817,217,"10","1","3","3","3","5.0","1.0","2.0","1.0","1.0"
"ranchi","jharkhand","Sundil","364.0","373535.0",2740,1398,1342,1562,929,633,1076,732,344,"7","1","2","3","1","5.0","1.0","2.0","1.0","1.0"
"ranchi","jharkhand","Dhanaisoso","364.0","373536.0",924,495,429,534,320,214,252,227,25,"7","1","2","3","1","5.0","1.0","2.0","1.0","1.0"
"ranchi","jharkhand","Chatakpur","364.0","373537.0",4153,2216,1937,2512,1487,1025,1090,987,103,"6","1","2","2","1","5.0","1.0","2.0","1.0","1.0"
"ranchi","jharkhand","Pandra","364.0","373538.0",3921,2084,1837,3160,1746,1414,1328,1065,263,"11","2","3","3","3","7.0","1.0","2.0","3.0","1.0"
"ranchi","jharkhand","Nauasoso","364.0","373539.0",1116,569,547,690,384,306,349,270,79,"8","1","3","3","1","5.0","1.0","2.0","1.0","1.0"
"ranchi","jharkhand","Konge","364.0","373540.0",1276,652,624,678,407,271,415,303,112,"9","1","2","3","3","5.0","1.0","2.0","1.0","1.0"
"ranchi","jharkhand","Garu","364.0","373542.0",1325,664,661,739,450,289,374,333,41,"7","1","3","2","1","5.0","1.0","2.0","1.0","1.0"
"ranchi","jharkhand","Sukurhuttu","364.0","373543.0",11862,6277,5585,7542,4647,2895,4495,3294,1201,"8","1","3","3","1","5.0","1.0","2.0","1.0","1.0"
"ranchi","jharkhand","Kadma","364.0","373544.0",1330,663,667,975,543,432,470,310,160,"8","1","3","3","1","7.0","1.0","2.0","1.0","3.0"
"ranchi","jharkhand","Hochar","364.0","373546.0",3818,1899,1919,2009,1135,874,2196,1146,1050,"8","2","2","3","1","5.0","1.0","2.0","1.0","1.0"
"ranchi","jharkhand","Sangrampur","364.0","373547.0",1740,880,860,915,535,380,847,472,375,"6","1","1","3","1","5.0","1.0","2.0","1.0","1.0"
"ranchi","jharkhand","Patratu","364.0","373548.0",678,321,357,400,216,184,317,146,171,"5","2","1","1","1","5.0","1.0","2.0","1.0","1.0"
"ranchi","jharkhand","Kareyadih","364.0","373838.0",1022,507,515,685,407,278,583,271,312,"5","1","2","1","1","5.0","1.0","2.0","1.0","1.0"
"ranchi","jharkhand","Patrahatu(Patrahattu)","364.0","373839.0",2835,1465,1370,1838,1072,766,1207,773,434,"7","1","2","1","3","5.0","1.0","2.0","1.0","1.0"
"ranchi","jharkhand","Chottachangru","364.0","373840.0",592,306,286,350,215,135,336,171,165,"4","1","1","1","1","5.0","1.0","2.0","1.0","1.0"
"ranchi","jharkhand","Barachangru","364.0","373841.0",1773,909,864,1068,668,400,957,501,456,"4","1","1","1","1","5.0","1.0","2.0","1.0","1.0"
"ranchi","jharkhand","Aral","364.0","373842.0",568,291,277,347,213,134,336,169,167,"4","1","1","1","1","6.0","2.0","2.0","1.0","1.0"
"ranchi","jharkhand","Nawadih","364.0","373843.0",1748,883,865,1076,624,452,1061,523,538,"4","1","1","1","1","5.0","1.0","2.0","1.0","1.0"
"ranchi","jharkhand","Ghaghra","364.0","373844.0",1012,507,505,605,350,255,572,288,284,"4","1","1","1","1","5.0","1.0","2.0","1.0","1.0"
"ranchi","jharkhand","Gorha","364.0","373845.0",623,332,291,365,238,127,348,183,165,"4","1","1","1","1","6.0","2.0","2.0","1.0","1.0"
"ranchi","jharkhand","Murhu","364.0","373846.0",651,336,315,454,263,191,295,156,139,"4","1","1","1","1","6.0","2.0","2.0","1.0","1.0"
"ranchi","jharkhand","Tunku","364.0","373847.0",1137,565,572,699,429,270,606,311,295,"4","1","1","1","1","6.0","2.0","2.0","1.0","1.0"
"ranchi","jharkhand","Kita","364.0","373848.0",528,272,256,404,232,172,158,128,30,"4","1","1","1","1","6.0","2.0","2.0","1.0","1.0"
"ranchi","jharkhand","Harwadih","364.0","373849.0",836,411,425,497,295,202,502,240,262,"5","1","2","1","1","6.0","2.0","2.0","1.0","1.0"
"ranchi","jharkhand","Lota","364.0","373850.0",4760,2417,2343,2917,1769,1148,1791,1259,532,"5","1","2","1","1","6.0","2.0","2.0","1.0","1.0"
"ranchi","jharkhand","Itihasa","364.0","373852.0",569,294,275,388,219,169,341,172,169,"5","1","2","1","1","5.0","1.0","2.0","1.0","1.0"
"ranchi","jharkhand","Chatambari","364.0","373854.0",706,353,353,446,275,171,440,214,226,"4","1","1","1","1","6.0","2.0","2.0","1.0","1.0"
"ranchi","jharkhand","Sillidih","364.0","373855.0",1064,559,505,669,407,262,555,298,257,"5","2","1","1","1","5.0","1.0","2.0","1.0","1.0"
"ranchi","jharkhand","Sarjamdih","364.0","373856.0",557,291,266,358,221,137,326,155,171,"4","1","1","1","1","6.0","2.0","2.0","1.0","1.0"
"ranchi","jharkhand","Chordera","364.0","373857.0",220,122,98,127,79,48,118,58,60,"6","2","2","1","1","6.0","2.0","2.0","1.0","1.0"
"ranchi","jharkhand","Barkitanr","364.0","373858.0",488,242,246,335,189,146,262,130,132,"6","2","2","1","1","6.0","2.0","2.0","1.0","1.0"
"ranchi","jharkhand","Jaru","364.0","373859.0",342,177,165,218,136,82,179,93,86,"4","1","1","1","1","8.0","2.0","2.0","3.0","1.0"
"ranchi","jharkhand","Dhautikra","364.0","373860.0",403,200,203,241,138,103,239,123,116,"4","1","1","1","1","6.0","2.0","2.0","1.0","1.0"
"ranchi","jharkhand","Kachojara","364.0","373861.0",86,50,36,69,41,28,39,23,16,"7","1","2","3","1","4.0","1.0","1.0","1.0","1.0"
"ranchi","jharkhand","Mijra","364.0","373862.0",251,139,112,177,104,73,104,67,37,"4","1","1","1","1","5.0","1.0","2.0","1.0","1.0"
"ranchi","jharkhand","Lupung","364.0","373863.0",2737,1419,1318,2027,1152,875,867,722,145,"10","1","3","3","3","5.0","2.0","1.0","1.0","1.0"
"ranchi","jharkhand","Lawapiri","364.0","373864.0",613,320,293,440,255,185,272,181,91,"8","1","3","1","3","5.0","2.0","1.0","1.0","1.0"
"ranchi","jharkhand","Khapchabera","364.0","373865.0",323,175,148,195,118,77,145,97,48,"4","1","1","1","1","4.0","1.0","1.0","1.0","1.0"
"ranchi","jharkhand","Jatra","364.0","373866.0",49,23,26,39,20,19,21,14,7,"5","1","2","1","1","6.0","2.0","2.0","1.0","1.0"
"ranchi","jharkhand","Nimua","364.0","373867.0",174,84,90,116,59,57,54,46,8,"5","1","2","1","1","7.0","1.0","2.0","3.0","1.0"
"ranchi","jharkhand","Singhpur","364.0","373868.0",1576,889,687,1178,743,435,739,366,373,"5","1","2","1","1","5.0","1.0","2.0","1.0","1.0"
"ranchi","jharkhand","Lenghatu","364.0","373869.0",1848,964,884,1319,784,535,756,544,212,"5","1","2","1","1","5.0","1.0","2.0","1.0","1.0"
"ranchi","jharkhand","Sulumjuri","364.0","373872.0",1045,544,501,676,391,285,384,276,108,"7","1","2","3","1","6.0","2.0","2.0","1.0","1.0"
"ranchi","jharkhand","Nayakjabla","364.0","373874.0",329,160,169,220,120,100,161,93,68,"5","1","2","1","1","6.0","2.0","2.0","1.0","1.0"
"ranchi","jharkhand","Jabla","364.0","373878.0",518,257,261,352,197,155,176,128,48,"5","1","2","1","1","5.0","1.0","2.0","1.0","1.0"
"ranchi","jharkhand","Silli","364.0","373879.0",5222,2684,2538,3519,2071,1448,2299,1500,799,"7","1","2","3","1","6.0","2.0","2.0","1.0","1.0"
"ranchi","jharkhand","Sundil","364.0","373881.0",689,341,348,479,268,211,349,177,172,"5","1","2","1","1","5.0","1.0","2.0","1.0","1.0"
"ranchi","jharkhand","Kocho(Koncho)","364.0","373882.0",1702,862,840,1181,685,496,955,466,489,"5","1","2","1","1","5.0","1.0","2.0","1.0","1.0"
"ranchi","jharkhand","Hahelupung","364.0","373883.0",1818,946,872,1223,744,479,783,540,243,"5","1","2","1","1","6.0","2.0","2.0","1.0","1.0"
"ranchi","jharkhand","Tutki","364.0","373884.0",2048,1029,1019,1399,818,581,1413,714,699,"5","1","2","1","1","5.0","1.0","2.0","1.0","1.0"
"ranchi","jharkhand","Chokesiring","364.0","373886.0",1108,556,552,740,429,311,426,267,159,"5","1","2","1","1","5.0","1.0","2.0","1.0","1.0"
"ranchi","jharkhand","Domandih","364.0","373889.0",566,277,289,372,212,160,204,163,41,"7","1","2","3","1","5.0","1.0","2.0","1.0","1.0"
"ranchi","jharkhand","Lawadag","364.0","373890.0",966,496,470,623,367,256,423,238,185,"5","1","2","1","1","5.0","1.0","2.0","1.0","1.0"
"ranchi","jharkhand","Dharampur","364.0","373891.0",264,148,116,150,97,53,91,91,0,"4","1","1","1","1","7.0","3.0","2.0","1.0","1.0"
"ranchi","jharkhand","Bantahajam","364.0","373892.0",8677,4396,4281,5125,3084,2041,4163,2323,1840,"5","1","2","1","1","5.0","1.0","2.0","1.0","1.0"
"ranchi","jharkhand","Jhabri(Ghabari)","364.0","373893.0",1220,627,593,694,470,224,639,362,277,"4","1","1","1","1","5.0","1.0","2.0","1.0","1.0"
"ranchi","jharkhand","Garihalmad","364.0","373894.0",328,166,162,169,110,59,189,94,95,"4","1","1","1","1","5.0","1.0","2.0","1.0","1.0"
"ranchi","jharkhand","Shyamnagar","364.0","373895.0",396,202,194,259,153,106,242,124,118,"5","2","1","1","1","5.0","1.0","2.0","1.0","1.0"
"ranchi","jharkhand","Konkadih","364.0","373900.0",700,345,355,333,210,123,413,200,213,"4","1","1","1","1","7.0","1.0","2.0","3.0","1.0"
"ranchi","jharkhand","Mahil","364.0","373901.0",1197,595,602,611,381,230,680,332,348,"5","1","2","1","1","5.0","1.0","2.0","1.0","1.0"
"ranchi","jharkhand","Jilingsereng","364.0","373902.0",1324,670,654,601,404,197,872,436,436,"4","1","1","1","1","5.0","1.0","2.0","1.0","1.0"
"ranchi","jharkhand","Bongadar","364.0","373905.0",529,286,243,284,184,100,326,178,148,"4","1","1","1","1","5.0","1.0","2.0","1.0","1.0"
"ranchi","jharkhand","Pandadih","364.0","373907.0",829,428,401,518,302,216,396,241,155,"7","1","2","3","1","7.0","2.0","2.0","2.0","1.0"
"ranchi","jharkhand","Napra","364.0","373908.0",316,164,152,195,119,76,182,93,89,"7","2","2","2","1","7.0","1.0","2.0","3.0","1.0"
"ranchi","jharkhand","Buruhatu Sundrup","364.0","373915.0",945,482,463,587,370,217,512,256,256,"6","1","1","3","1","5.0","1.0","2.0","1.0","1.0"
"ranchi","jharkhand","Baredih","364.0","373916.0",974,494,480,553,336,217,488,258,230,"5","1","1","2","1","5.0","1.0","2.0","1.0","1.0"
"ranchi","jharkhand","Banku","364.0","373917.0",1128,557,571,602,367,235,588,281,307,"6","1","1","3","1","5.0","1.0","2.0","1.0","1.0"
"ranchi","jharkhand","Harin","364.0","373918.0",1783,879,904,1023,604,419,1031,536,495,"4","1","1","1","1","5.0","1.0","2.0","1.0","1.0"
"ranchi","jharkhand","Jurunga","364.0","373919.0",561,291,270,320,195,125,234,139,95,"5","1","2","1","1","5.0","1.0","2.0","1.0","1.0"
"ranchi","jharkhand","Loadih","364.0","373920.0",1163,565,598,663,401,262,666,313,353,"6","1","1","3","1","6.0","2.0","2.0","1.0","1.0"
"ranchi","jharkhand","Sigid","364.0","373921.0",726,366,360,410,252,158,414,193,221,"4","1","1","1","1","5.0","1.0","2.0","1.0","1.0"
"ranchi","jharkhand","Domadih","364.0","373922.0",632,308,324,433,240,193,393,180,213,"4","1","1","1","1","5.0","1.0","2.0","1.0","1.0"
"ranchi","jharkhand","Marchadih","364.0","373923.0",373,176,197,204,109,95,219,103,116,"4","1","1","1","1","5.0","1.0","2.0","1.0","1.0"
"ranchi","jharkhand","Erramhatu","364.0","373924.0",921,450,471,501,297,204,716,348,368,"5","1","1","2","1","7.0","2.0","2.0","2.0","1.0"
"ranchi","jharkhand","Tetwadih","364.0","373925.0",1183,617,566,739,463,276,821,417,404,"4","1","1","1","1","6.0","2.0","2.0","1.0","1.0"
"ranchi","jharkhand","Paramjarea","364.0","373926.0",126,64,62,79,46,33,88,48,40,"4","1","1","1","1","7.0","1.0","2.0","3.0","1.0"
"ranchi","jharkhand","Dibadih","364.0","373927.0",597,318,279,370,228,142,412,227,185,"6","2","2","1","1","5.0","1.0","2.0","1.0","1.0"
"ranchi","jharkhand","Somadih","364.0","373928.0",878,452,426,465,283,182,536,271,265,"4","1","1","1","1","5.0","1.0","2.0","1.0","1.0"
"ranchi","jharkhand","Jintudih","364.0","373929.0",422,214,208,230,150,80,246,124,122,"4","1","1","1","1","5.0","1.0","2.0","1.0","1.0"
"ranchi","jharkhand","Birdidih","364.0","373930.0",628,321,307,330,193,137,345,171,174,"4","1","1","1","1","5.0","1.0","2.0","1.0","1.0"
"ranchi","jharkhand","Salsud","364.0","373931.0",1515,772,743,866,541,325,943,480,463,"4","1","1","1","1","5.0","1.0","2.0","1.0","1.0"
"ranchi","jharkhand","Baluadih","364.0","373932.0",939,487,452,499,307,192,240,236,4,"5","1","2","1","1","5.0","1.0","2.0","1.0","1.0"
"ranchi","jharkhand","Poring Chauli","364.0","373933.0",435,228,207,307,172,135,235,117,118,"4","1","1","1","1","5.0","1.0","2.0","1.0","1.0"
"ranchi","jharkhand","Konda","364.0","373934.0",252,122,130,163,93,70,164,81,83,"5","1","2","1","1","5.0","1.0","2.0","1.0","1.0"
"ranchi","jharkhand","Irku","364.0","373935.0",704,357,347,405,242,163,425,213,212,"4","1","1","1","1","6.0","1.0","2.0","2.0","1.0"
"ranchi","jharkhand","Kotab","364.0","373936.0",379,191,188,214,137,77,228,111,117,"4","1","1","1","1","5.0","1.0","2.0","1.0","1.0"
"ranchi","jharkhand","Kudadih","364.0","373937.0",527,270,257,360,225,135,297,149,148,"5","1","2","1","1","4.0","1.0","1.0","1.0","1.0"
"ranchi","jharkhand","Tetla","364.0","373938.0",2459,1271,1188,1368,820,548,1058,615,443,"4","1","1","1","1","5.0","1.0","2.0","1.0","1.0"
"ranchi","jharkhand","Hesahatu","364.0","373939.0",260,126,134,154,91,63,138,70,68,"4","1","1","1","1","6.0","2.0","2.0","1.0","1.0"
"ranchi","jharkhand","Magandih","364.0","373940.0",704,353,351,369,225,144,357,178,179,"4","1","1","1","1","6.0","2.0","2.0","1.0","1.0"
"ranchi","jharkhand","Jamudag","364.0","373941.0",3322,1709,1613,2004,1205,799,1604,871,733,"5","1","2","1","1","5.0","1.0","2.0","1.0","1.0"
"ranchi","jharkhand","Jahirdih","364.0","373942.0",551,274,277,340,208,132,275,135,140,"4","1","1","1","1","5.0","1.0","2.0","1.0","1.0"
"ranchi","jharkhand","Choga","364.0","373943.0",1334,675,659,757,451,306,783,391,392,"4","1","1","1","1","7.0","2.0","2.0","2.0","1.0"
"ranchi","jharkhand","Dirsir","364.0","373944.0",893,460,433,496,298,198,591,297,294,"6","2","2","1","1","7.0","1.0","2.0","3.0","1.0"
"ranchi","jharkhand","Saread","364.0","373945.0",668,329,339,448,261,187,378,174,204,"4","1","1","1","1","4.0","1.0","1.0","1.0","1.0"
"ranchi","jharkhand","Saelband","364.0","373946.0",486,261,225,313,189,124,294,153,141,"5","1","1","2","1","5.0","1.0","2.0","1.0","1.0"
"ranchi","jharkhand","Birgamdih","364.0","373947.0",574,283,291,356,207,149,325,157,168,"5","2","1","1","1","4.0","1.0","1.0","1.0","1.0"
"ranchi","jharkhand","Rangadih","364.0","373948.0",86,35,51,48,25,23,47,19,28,"4","1","1","1","1","5.0","1.0","2.0","1.0","1.0"
"ranchi","jharkhand","Garadih","364.0","373949.0",1181,614,567,661,427,234,692,344,348,"4","1","1","1","1","5.0","1.0","2.0","1.0","1.0"
"ranchi","jharkhand","Sarmali","364.0","373950.0",527,272,255,351,200,151,303,150,153,"5","1","2","1","1","7.0","1.0","2.0","1.0","3.0"
"ranchi","jharkhand","Sonahatu","364.0","373951.0",2683,1332,1351,1418,842,576,1457,723,734,"4","1","1","1","1","4.0","1.0","1.0","1.0","1.0"
"ranchi","jharkhand","Gomeadih","364.0","373952.0",856,419,437,590,319,271,439,195,244,"8","2","2","3","1","5.0","1.0","2.0","1.0","1.0"
"ranchi","jharkhand","Baruhatu","364.0","373953.0",2271,1185,1086,1525,908,617,1396,737,659,"5","1","2","1","1","5.0","1.0","2.0","1.0","1.0"
"ranchi","jharkhand","Nakidih","364.0","373954.0",883,436,447,448,270,178,514,251,263,"4","1","1","1","1","5.0","1.0","2.0","1.0","1.0"
"ranchi","jharkhand","Kuriamu","364.0","373955.0",744,369,375,497,297,200,479,233,246,"5","2","1","1","1","5.0","1.0","2.0","1.0","1.0"
"ranchi","jharkhand","Poadiri","364.0","373956.0",491,277,214,260,185,75,331,187,144,"4","1","1","1","1","6.0","2.0","2.0","1.0","1.0"
"ranchi","jharkhand","Jintu","364.0","373957.0",2089,1068,1021,1333,786,547,1261,623,638,"4","1","1","1","1","5.0","1.0","2.0","1.0","1.0"
"ranchi","jharkhand","Serenghatu","364.0","373958.0",1186,577,609,677,392,285,702,340,362,"4","1","1","1","1","5.0","1.0","2.0","1.0","1.0"
"ranchi","jharkhand","Nimdih","364.0","373959.0",1343,673,670,805,483,322,819,405,414,"5","1","2","1","1","5.0","1.0","2.0","1.0","1.0"
"ranchi","jharkhand","Galau","364.0","373960.0",1734,880,854,944,582,362,1014,501,513,"6","1","1","3","1","7.0","3.0","2.0","1.0","1.0"
"ranchi","jharkhand","Silwai","364.0","373961.0",4837,2508,2329,2801,1694,1107,2469,1417,1052,"5","1","2","1","1","6.0","2.0","2.0","1.0","1.0"
"ranchi","jharkhand","Haratu","364.0","373962.0",2858,1541,1317,2153,1268,885,989,767,222,"10","1","3","3","3","4.0","1.0","1.0","1.0","1.0"
"ranchi","jharkhand","Mahilong","364.0","373963.0",4371,2225,2146,2842,1630,1212,1634,1054,580,"6","1","3","1","1","6.0","3.0","1.0","1.0","1.0"
"ranchi","jharkhand","Baram","364.0","373964.0",4215,2070,2145,2226,1242,984,2229,1124,1105,"5","1","2","1","1","5.0","1.0","2.0","1.0","1.0"
"ranchi","jharkhand","Kewali","364.0","373965.0",1285,654,631,792,437,355,510,306,204,"5","1","2","1","1","4.0","1.0","1.0","1.0","1.0"
"ranchi","jharkhand","Sidraul","364.0","373966.0",3316,1713,1603,2432,1346,1086,1100,792,308,"8","1","3","3","1","5.0","1.0","2.0","1.0","1.0"
"ranchi","jharkhand","Khijri","364.0","373967.0",5936,3070,2866,4701,2583,2118,2155,1518,637,"11","2","3","3","3","5.0","1.0","2.0","1.0","1.0"
"ranchi","jharkhand","Pindarkam","364.0","373970.0",1235,649,586,835,477,358,384,285,99,"5","1","2","1","1","7.0","3.0","2.0","1.0","1.0"
"ranchi","jharkhand","Sithia","364.0","373971.0",3730,1897,1833,2428,1383,1045,1432,977,455,"6","1","3","1","1","5.0","1.0","2.0","1.0","1.0"
"ranchi","jharkhand","Sohdag","364.0","373972.0",1671,866,805,826,554,272,873,439,434,"6","2","2","1","1","6.0","1.0","3.0","1.0","1.0"
"ranchi","jharkhand","Banda","364.0","373973.0",153,82,71,98,60,38,94,64,30,"4","1","1","1","1","7.0","2.0","3.0","1.0","1.0"
"ranchi","jharkhand","Garsul","364.0","373974.0",962,503,459,542,335,207,475,247,228,"4","1","1","1","1","5.0","1.0","2.0","1.0","1.0"
"ranchi","jharkhand","Huringdag","364.0","373975.0",363,181,182,170,99,71,96,71,25,"4","1","1","1","1","4.0","1.0","1.0","1.0","1.0"
"ranchi","jharkhand","Darjitorar","364.0","373976.0",285,148,137,116,70,46,243,124,119,"4","1","1","1","1","5.0","1.0","2.0","1.0","1.0"
"ranchi","jharkhand","Hethdahu","364.0","373977.0",694,352,342,335,196,139,201,158,43,"5","1","2","1","1","5.0","1.0","2.0","1.0","1.0"
"ranchi","jharkhand","Jamgain","364.0","373979.0",949,454,495,589,320,269,420,219,201,"5","1","2","1","1","5.0","1.0","2.0","1.0","1.0"
"ranchi","jharkhand","Ghuthiya","364.0","373980.0",610,293,317,348,193,155,243,160,83,"5","1","2","1","1","5.0","1.0","2.0","1.0","1.0"
"ranchi","jharkhand","Huthundu","364.0","373981.0",2122,1039,1083,1717,874,843,684,425,259,"10","1","3","3","3","7.0","3.0","2.0","1.0","1.0"
"ranchi","jharkhand","Gundu","364.0","373982.0",1970,938,1032,1526,763,763,552,352,200,"10","1","3","3","3","5.0","1.0","2.0","1.0","1.0"
"ranchi","jharkhand","Sukurhuttu","364.0","373983.0",1112,540,572,826,432,394,355,250,105,"10","1","3","3","3","5.0","1.0","2.0","1.0","1.0"
"ranchi","jharkhand","Chand","364.0","373985.0",760,368,392,459,243,216,372,194,178,"5","1","2","1","1","4.0","1.0","1.0","1.0","1.0"
"ranchi","jharkhand","Dundu","364.0","373988.0",819,393,426,262,164,98,383,228,155,"4","1","1","1","1","5.0","1.0","2.0","1.0","1.0"
"ranchi","jharkhand","Hardag","364.0","373989.0",2030,1034,996,1034,617,417,661,484,177,"5","2","1","1","1","7.0","3.0","2.0","1.0","1.0"
"ranchi","jharkhand","Hoenjan","364.0","373990.0",601,301,300,404,225,179,217,152,65,"6","2","2","1","1","6.0","3.0","1.0","1.0","1.0"
"ranchi","jharkhand","Sorha(Sotha)","364.0","373991.0",481,252,229,267,164,103,199,133,66,"4","1","1","1","1","5.0","1.0","2.0","1.0","1.0"
"ranchi","jharkhand","Barguttu","364.0","373992.0",672,338,334,442,252,190,227,180,47,"6","2","2","1","1","5.0","1.0","2.0","1.0","1.0"
"ranchi","jharkhand","Saheda","364.0","373994.0",766,380,386,374,211,163,191,163,28,"4","1","1","1","1","7.0","3.0","2.0","1.0","1.0"
"ranchi","jharkhand","Hajam","364.0","373995.0",672,340,332,213,138,75,302,180,122,"5","2","1","1","1","5.0","1.0","2.0","1.0","1.0"
"ranchi","jharkhand","Dundigarha","364.0","373996.0",520,247,273,248,129,119,153,116,37,"6","2","2","1","1","5.0","1.0","2.0","1.0","1.0"
"ranchi","jharkhand","Nichitpur-Raydih","364.0","373997.0",860,446,414,454,293,161,409,225,184,"4","1","1","1","1","5.0","1.0","2.0","1.0","1.0"
"ranchi","jharkhand","Karkata","364.0","373999.0",533,276,257,303,181,122,295,147,148,"4","1","1","1","1","5.0","1.0","2.0","1.0","1.0"
"ranchi","jharkhand","Tunju","364.0","374000.0",545,282,263,222,143,79,392,205,187,"5","2","1","1","1","7.0","3.0","2.0","1.0","1.0"
"ranchi","jharkhand","Nachaldag","364.0","374001.0",834,443,391,359,222,137,490,267,223,"5","2","1","1","1","5.0","1.0","2.0","1.0","1.0"
"ranchi","jharkhand","Butiyo","364.0","374002.0",392,192,200,165,95,70,207,93,114,"4","1","1","1","1","5.0","1.0","2.0","1.0","1.0"
"ranchi","jharkhand","Dewgain","364.0","374003.0",956,472,484,554,339,215,423,262,161,"4","1","1","1","1","5.0","1.0","2.0","1.0","1.0"
"ranchi","jharkhand","Siri","364.0","374004.0",185,97,88,63,36,27,108,59,49,"4","1","1","1","1","6.0","2.0","2.0","1.0","1.0"
"ranchi","jharkhand","Kiski","364.0","374006.0",704,345,359,339,203,136,453,237,216,"5","1","2","1","1","5.0","1.0","2.0","1.0","1.0"
"ranchi","jharkhand","Jaratoli","364.0","374007.0",250,132,118,181,103,78,94,52,42,"5","1","2","1","1","6.0","2.0","2.0","1.0","1.0"
"ranchi","jharkhand","Dungri","364.0","374008.0",3006,1526,1480,1954,1129,825,1058,702,356,"6","1","3","1","1","5.0","1.0","2.0","1.0","1.0"
"ranchi","jharkhand","Tanko","364.0","374009.0",1481,739,742,922,553,369,579,365,214,"6","1","3","1","1","5.0","1.0","2.0","1.0","1.0"
"ranchi","jharkhand","Garhkhatanga","364.0","374010.0",1007,493,514,548,327,221,437,240,197,"4","1","1","1","1","5.0","1.0","2.0","1.0","1.0"
"ranchi","jharkhand","Oberiya","364.0","374011.0",1520,762,758,935,527,408,589,373,216,"6","1","3","1","1","5.0","1.0","2.0","1.0","1.0"
"ranchi","jharkhand","Kute Toli","364.0","374013.0",1185,625,560,540,307,233,314,261,53,"6","2","2","1","1","7.0","1.0","2.0","3.0","1.0"
"ranchi","jharkhand","Chandaghasi","364.0","374014.0",1476,741,735,720,412,308,640,366,274,"5","1","2","1","1","4.0","1.0","1.0","1.0","1.0"
"ranchi","jharkhand","Tumbaguttu","364.0","374015.0",3014,1524,1490,2026,1143,883,1225,742,483,"7","1","2","3","1","5.0","1.0","2.0","1.0","1.0"
"ranchi","jharkhand","Lodhma","364.0","374016.0",1130,573,557,736,424,312,511,310,201,"6","1","3","1","1","7.0","3.0","2.0","1.0","1.0"
"ranchi","jharkhand","Mariyatu","364.0","374017.0",203,95,108,106,60,46,70,55,15,"6","1","3","1","1","5.0","1.0","2.0","1.0","1.0"
"ranchi","jharkhand","Ithe","364.0","374018.0",234,125,109,159,94,65,112,63,49,"7","2","3","1","1","5.0","1.0","2.0","1.0","1.0"
"ranchi","jharkhand","Lalkhatanga","364.0","374019.0",1156,578,578,753,445,308,495,277,218,"5","1","2","1","1","5.0","1.0","2.0","1.0","1.0"
"ranchi","jharkhand","Kachbang","364.0","374020.0",1063,531,532,579,329,250,461,277,184,"5","1","2","1","1","5.0","1.0","2.0","1.0","1.0"
"ranchi","jharkhand","Mangubadh","364.0","374022.0",246,116,130,180,103,77,138,70,68,"4","1","1","1","1","6.0","2.0","2.0","1.0","1.0"
"ranchi","jharkhand","Hurua","364.0","374023.0",1120,548,572,497,298,199,455,304,151,"4","1","1","1","1","5.0","1.0","2.0","1.0","1.0"
"ranchi","jharkhand","Rurungkocha","364.0","374024.0",427,223,204,277,168,109,205,99,106,"5","1","2","1","1","5.0","1.0","2.0","1.0","1.0"
"ranchi","jharkhand","Bundubera","364.0","374025.0",643,315,328,315,189,126,390,179,211,"4","1","1","1","1","7.0","3.0","2.0","1.0","1.0"
"ranchi","jharkhand","Bandua","364.0","374026.0",877,438,439,464,269,195,616,294,322,"4","1","1","1","1","5.0","1.0","2.0","1.0","1.0"
"ranchi","jharkhand","Kolad","364.0","374027.0",863,439,424,424,269,155,445,235,210,"4","1","1","1","1","5.0","1.0","2.0","1.0","1.0"
"ranchi","jharkhand","Ulatu","364.0","374028.0",1089,551,538,484,293,191,525,269,256,"4","1","1","1","1","6.0","1.0","3.0","1.0","1.0"
"ranchi","jharkhand","Kakra","364.0","374029.0",882,443,439,396,243,153,723,369,354,"4","1","1","1","1","7.0","2.0","3.0","1.0","1.0"
"ranchi","jharkhand","Singarsarai","364.0","374030.0",836,405,431,321,201,120,479,222,257,"5","2","1","1","1","5.0","1.0","2.0","1.0","1.0"
"ranchi","jharkhand","Huanghatu","364.0","374031.0",1375,659,716,678,413,265,847,435,412,"4","1","1","1","1","5.0","1.0","2.0","1.0","1.0"
"ranchi","jharkhand","Harbul","364.0","374032.0",78,44,34,25,18,7,54,28,26,"4","1","1","1","1","6.0","2.0","2.0","1.0","1.0"
"ranchi","jharkhand","Jareya","364.0","374033.0",1125,539,586,537,319,218,833,399,434,"4","1","1","1","1","5.0","1.0","2.0","1.0","1.0"
"ranchi","jharkhand","Ulidih","364.0","374034.0",1145,546,599,607,337,270,738,365,373,"5","1","2","1","1","8.0","3.0","3.0","1.0","1.0"
"ranchi","jharkhand","Hahap","364.0","374035.0",2092,1042,1050,961,580,381,1145,593,552,"4","1","1","1","1","5.0","1.0","2.0","1.0","1.0"
"ranchi","jharkhand","Saparom","364.0","374036.0",544,276,268,271,154,117,447,222,225,"6","1","1","1","3","5.0","1.0","2.0","1.0","1.0"
"ranchi","jharkhand","Koenribera","364.0","374037.0",400,182,218,193,100,93,205,120,85,"4","1","1","1","1","6.0","2.0","2.0","1.0","1.0"
"ranchi","jharkhand","Tetri","364.0","374039.0",1473,763,710,1049,595,454,622,406,216,"4","1","1","1","1","5.0","1.0","2.0","1.0","1.0"
"ranchi","jharkhand","Kharsidag","364.0","374040.0",599,304,295,406,221,185,167,124,43,"6","2","2","1","1","5.0","1.0","2.0","1.0","1.0"
"ranchi","jharkhand","Churu","364.0","374041.0",638,317,321,340,195,145,260,149,111,"5","1","2","1","1","5.0","1.0","2.0","1.0","1.0"
"ranchi","jharkhand","Pindarkom","364.0","374042.0",639,314,325,485,253,232,177,138,39,"10","1","3","3","3","4.0","1.0","1.0","1.0","1.0"
"ranchi","jharkhand","Sahera","364.0","374043.0",659,276,383,436,189,247,257,144,113,"6","2","2","1","1","5.0","1.0","2.0","1.0","1.0"
"ranchi","jharkhand","Kutiatu","364.0","374044.0",1916,961,955,1156,670,486,844,470,374,"6","1","3","1","1","4.0","1.0","1.0","1.0","1.0"
"ranchi","jharkhand","Palandu","364.0","374045.0",1033,492,541,673,355,318,608,292,316,"6","1","3","1","1","5.0","1.0","2.0","1.0","1.0"
"ranchi","jharkhand","Malti","364.0","374046.0",684,318,366,406,222,184,376,175,201,"6","2","2","1","1","5.0","1.0","2.0","1.0","1.0"
"ranchi","jharkhand","Sarwal","364.0","374048.0",1530,765,765,797,450,347,770,406,364,"4","1","1","1","1","5.0","1.0","2.0","1.0","1.0"
"ranchi","jharkhand","Ganrke","364.0","374049.0",1044,510,534,715,397,318,665,338,327,"6","1","3","1","1","6.0","3.0","1.0","1.0","1.0"
"ranchi","jharkhand","Rampur","364.0","374050.0",1517,730,787,999,541,458,956,490,466,"6","2","2","1","1","5.0","1.0","2.0","1.0","1.0"
"ranchi","jharkhand","Chene","364.0","374051.0",1311,671,640,785,451,334,862,454,408,"6","2","2","1","1","5.0","1.0","2.0","1.0","1.0"
"ranchi","jharkhand","Jamchuan","364.0","374052.0",1460,737,723,807,478,329,816,410,406,"4","1","1","1","1","5.0","1.0","2.0","1.0","1.0"
"ranchi","jharkhand","Harhap","364.0","374054.0",516,248,268,309,183,126,245,140,105,"4","1","1","1","1","12.0","3.0","3.0","3.0","3.0"
"ranchi","jharkhand","Heslatoli","364.0","374055.0",1862,915,947,1045,623,422,1041,512,529,"4","1","1","1","1","5.0","1.0","2.0","1.0","1.0"
"ranchi","jharkhand","Kudagara","364.0","374057.0",1688,838,850,929,560,369,1007,513,494,"4","1","1","1","1","6.0","3.0","1.0","1.0","1.0"
"ranchi","jharkhand","Usamatu","364.0","374061.0",1030,520,510,616,345,271,418,242,176,"6","2","1","2","1","5.0","1.0","2.0","1.0","1.0"
"ranchi","jharkhand","Hochar","364.0","374063.0",356,175,181,199,119,80,90,78,12,"8","2","2","3","1","5.0","1.0","2.0","1.0","1.0"
"ranchi","jharkhand","Kokretanr","364.0","374064.0",94,53,41,56,38,18,22,22,0,"5","1","2","1","1","6.0","1.0","3.0","1.0","1.0"
"ranchi","jharkhand","Kanauj","364.0","374065.0",895,473,422,552,331,221,434,242,192,"6","2","2","1","1","8.0","3.0","1.0","1.0","3.0"
"ranchi","jharkhand","Banapiri","364.0","374066.0",2995,1549,1446,1792,1037,755,1162,728,434,"8","2","2","1","3","5.0","1.0","2.0","1.0","1.0"
"ranchi","jharkhand","Jari","364.0","374067.0",1647,856,791,1139,660,479,636,431,205,"5","2","1","1","1","8.0","1.0","3.0","3.0","1.0"
"ranchi","jharkhand","Piriyo","364.0","374068.0",2262,1074,1188,1322,711,611,854,440,414,"7","2","2","2","1","5.0","1.0","2.0","1.0","1.0"
"ranchi","jharkhand","Murchu","364.0","374069.0",948,479,469,427,272,155,385,236,149,"7","2","1","3","1","5.0","1.0","2.0","1.0","1.0"
"ranchi","jharkhand","Patratoli","364.0","374070.0",472,229,243,241,139,102,222,116,106,"5","2","1","1","1","6.0","2.0","2.0","1.0","1.0"
"ranchi","jharkhand","Parhepat","364.0","374071.0",1902,926,976,1119,613,506,519,428,91,"6","2","2","1","1","5.0","1.0","2.0","1.0","1.0"
"ranchi","jharkhand","Malmanru","364.0","374072.0",1037,529,508,613,357,256,467,271,196,"5","1","2","1","1","8.0","1.0","3.0","3.0","1.0"
"ranchi","jharkhand","Gutuatoli","364.0","374073.0",539,260,279,270,147,123,236,131,105,"6","2","2","1","1","7.0","1.0","2.0","3.0","1.0"
"ranchi","jharkhand","Pheta","364.0","374075.0",1894,958,936,869,504,365,810,495,315,"5","1","1","2","1","5.0","1.0","2.0","1.0","1.0"
"ranchi","jharkhand","Makhmandro","364.0","374076.0",1156,588,568,684,384,300,481,307,174,"5","1","2","1","1","5.0","1.0","2.0","1.0","1.0"
"ranchi","jharkhand","Burju","364.0","374077.0",439,223,216,342,184,158,127,103,24,"10","1","3","3","3","5.0","1.0","2.0","1.0","1.0"
"ranchi","jharkhand","Kantu","364.0","374078.0",766,391,375,503,288,215,355,215,140,"9","2","3","3","1","5.0","1.0","2.0","1.0","1.0"
"ranchi","jharkhand","Lahna","364.0","374079.0",1125,580,545,747,425,322,396,289,107,"10","1","3","3","3","5.0","1.0","2.0","1.0","1.0"
"ranchi","jharkhand","Belangi","364.0","374080.0",654,320,334,478,260,218,250,131,119,"7","2","3","1","1","8.0","1.0","3.0","3.0","1.0"
"ranchi","jharkhand","Pali","364.0","374082.0",2960,1498,1462,1759,1021,738,1206,807,399,"6","2","2","1","1","5.0","1.0","2.0","1.0","1.0"
"ranchi","jharkhand","Pandra","364.0","374083.0",1354,688,666,789,452,337,625,356,269,"4","1","1","1","1","5.0","1.0","2.0","1.0","1.0"
"ranchi","jharkhand","Tigra","364.0","374084.0",4713,2362,2351,2642,1529,1113,2297,1392,905,"6","2","2","1","1","6.0","1.0","3.0","1.0","1.0"
"ranchi","jharkhand","Chitarkota","364.0","374085.0",3051,1503,1548,1666,917,749,1369,707,662,"5","2","1","1","1","5.0","1.0","2.0","1.0","1.0"
"ranchi","jharkhand","Mariatu","364.0","374086.0",323,168,155,190,119,71,101,81,20,"5","1","2","1","1","5.0","1.0","2.0","1.0","1.0"
"ranchi","jharkhand","Ekaguri","364.0","374087.0",568,283,285,300,168,132,250,153,97,"5","1","2","1","1","6.0","1.0","3.0","1.0","1.0"
"ranchi","jharkhand","Hehal","364.0","374088.0",1845,896,949,1083,604,479,701,439,262,"8","2","2","3","1","5.0","1.0","2.0","1.0","1.0"
"ranchi","jharkhand","Agru","364.0","374089.0",2088,1023,1065,1318,726,592,959,536,423,"7","1","2","3","1","6.0","1.0","3.0","1.0","1.0"
"ranchi","jharkhand","Bijuliya","364.0","374090.0",2154,1109,1045,1353,799,554,867,578,289,"8","2","2","3","1","6.0","1.0","3.0","1.0","1.0"
"ranchi","jharkhand","Garri","364.0","374091.0",574,309,265,394,243,151,267,159,108,"6","2","2","1","1","5.0","1.0","2.0","1.0","1.0"
"ranchi","jharkhand","Guru","364.0","374092.0",1571,790,781,1055,604,451,948,484,464,"8","2","2","3","1","5.0","1.0","2.0","1.0","1.0"
"ranchi","jharkhand","Bajpur","364.0","374093.0",1917,951,966,1189,669,520,869,503,366,"6","2","2","1","1","5.0","1.0","2.0","1.0","1.0"
"ranchi","jharkhand","Hisri","364.0","374095.0",1134,570,564,616,348,268,255,241,14,"6","2","2","1","1","5.0","1.0","2.0","1.0","1.0"
"ranchi","jharkhand","Hetha","364.0","374096.0",927,465,462,554,309,245,478,257,221,"6","1","1","3","1","5.0","1.0","2.0","1.0","1.0"
"ranchi","jharkhand","Bhonra","364.0","374097.0",1141,571,570,692,399,293,428,276,152,"7","2","2","2","1","5.0","1.0","2.0","1.0","1.0"
"ranchi","jharkhand","Lada","364.0","374099.0",831,393,438,531,279,252,436,244,192,"7","3","2","1","1","6.0","1.0","3.0","1.0","1.0"
"ranchi","jharkhand","Erchora","364.0","374100.0",1574,817,757,1001,602,399,677,385,292,"5","1","2","1","1","5.0","1.0","2.0","1.0","1.0"
"ranchi","jharkhand","Patrachauli","364.0","374101.0",1277,632,645,829,462,367,466,326,140,"5","1","2","1","1","4.0","1.0","1.0","1.0","1.0"
"ranchi","jharkhand","Barsa","364.0","374102.0",693,345,348,447,259,188,311,176,135,"6","2","2","1","1","5.0","1.0","2.0","1.0","1.0"
"ranchi","jharkhand","Chipra","364.0","374103.0",1593,818,775,985,579,406,924,475,449,"8","1","3","3","1","5.0","1.0","2.0","1.0","1.0"
"ranchi","jharkhand","Babro","364.0","374104.0",271,132,139,147,65,82,125,63,62,"6","2","2","1","1","5.0","1.0","2.0","1.0","1.0"
"ranchi","jharkhand","Kosaro","364.0","374105.0",1179,577,602,734,395,339,527,264,263,"6","2","2","1","1","5.0","1.0","2.0","1.0","1.0"
"ranchi","jharkhand","Dewri","364.0","374106.0",3331,1749,1582,1924,1130,794,1082,771,311,"6","2","2","1","1","5.0","1.0","2.0","1.0","1.0"
"ranchi","jharkhand","Sugda","364.0","374107.0",714,359,355,448,248,200,209,167,42,"6","1","3","1","1","5.0","1.0","2.0","1.0","1.0"
"ranchi","jharkhand","Basila","364.0","374108.0",2128,1066,1062,1135,640,495,639,471,168,"6","2","2","1","1","6.0","1.0","3.0","1.0","1.0"
"ranchi","jharkhand","Harhi","364.0","374109.0",1099,566,533,589,333,256,480,288,192,"5","1","2","1","1","5.0","1.0","2.0","1.0","1.0"
"ranchi","jharkhand","Palandu","364.0","374110.0",769,402,367,390,240,150,312,167,145,"5","1","2","1","1","5.0","1.0","2.0","1.0","1.0"
"ranchi","jharkhand","Katarpa","364.0","374111.0",643,311,332,329,187,142,345,168,177,"6","2","2","1","1","5.0","1.0","2.0","1.0","1.0"
"ranchi","jharkhand","Saher","364.0","374112.0",3084,1583,1501,1797,1053,744,1578,829,749,"6","2","2","1","1","4.0","1.0","1.0","1.0","1.0"
"ranchi","jharkhand","Khunta","364.0","374113.0",870,419,451,514,270,244,352,206,146,"4","1","1","1","1","5.0","1.0","2.0","1.0","1.0"
"ranchi","jharkhand","Kenke","364.0","374114.0",482,229,253,167,92,75,101,81,20,"4","1","1","1","1","4.0","1.0","1.0","1.0","1.0"
"ranchi","jharkhand","Halhu","364.0","374115.0",1014,511,503,525,324,201,394,270,124,"4","1","1","1","1","4.0","1.0","1.0","1.0","1.0"
"ranchi","jharkhand","Bandheya","364.0","374116.0",851,435,416,490,297,193,260,187,73,"5","1","2","1","1","6.0","1.0","1.0","3.0","1.0"
"ranchi","jharkhand","Kelande","364.0","374117.0",777,383,394,484,266,218,224,194,30,"6","2","2","1","1","5.0","1.0","2.0","1.0","1.0"
"ranchi","jharkhand","Nagri","364.0","374118.0",6118,3125,2993,4100,2267,1833,2185,1496,689,"8","1","3","1","3","4.0","1.0","1.0","1.0","1.0"
"ranchi","jharkhand","Piska","364.0","374119.0",954,459,495,446,242,204,492,239,253,"7","2","1","3","1","5.0","1.0","2.0","1.0","1.0"
"ranchi","jharkhand","Kudlum","364.0","374120.0",1807,880,927,879,490,389,899,476,423,"7","2","1","3","1","5.0","1.0","2.0","1.0","1.0"
"ranchi","jharkhand","Tikratoli","364.0","374121.0",2355,1161,1194,1375,762,613,688,476,212,"7","1","2","3","1","4.0","1.0","1.0","1.0","1.0"
"ranchi","jharkhand","Naro","364.0","374122.0",3264,1649,1615,2230,1209,1021,1028,747,281,"10","1","3","3","3","5.0","1.0","2.0","1.0","1.0"
"ranchi","jharkhand","Upardaha","364.0","374123.0",630,310,320,346,196,150,284,151,133,"7","1","2","3","1","5.0","1.0","2.0","1.0","1.0"
"ranchi","jharkhand","Tusmu","364.0","374124.0",635,344,291,388,237,151,348,189,159,"6","2","2","1","1","5.0","1.0","2.0","1.0","1.0"
"ranchi","jharkhand","Kolambi","364.0","374125.0",1006,481,525,611,323,288,449,230,219,"8","2","2","3","1","5.0","1.0","2.0","1.0","1.0"
"ranchi","jharkhand","Panchdiha","364.0","374126.0",420,209,211,258,146,112,175,99,76,"5","2","1","1","1","5.0","1.0","2.0","1.0","1.0"
"ranchi","jharkhand","Daladili","364.0","374127.0",875,438,437,500,300,200,355,229,126,"7","2","3","1","1","5.0","1.0","2.0","1.0","1.0"
"ranchi","jharkhand","Sisai","364.0","374276.0",867,421,446,407,224,183,220,183,37,"6","1","1","3","1","5.0","1.0","2.0","1.0","1.0"
"ranchi","jharkhand","Barhe","364.0","374277.0",1266,670,596,660,387,273,515,308,207,"9","1","2","3","3","5.0","1.0","2.0","1.0","1.0"
"ranchi","jharkhand","Bejang","364.0","374278.0",1006,468,538,544,290,254,531,265,266,"6","1","2","2","1","5.0","1.0","2.0","1.0","1.0"
"ranchi","jharkhand","Hutar","364.0","374279.0",2982,1512,1470,1667,973,694,1224,711,513,"4","1","1","1","1","5.0","1.0","2.0","1.0","1.0"
"ranchi","jharkhand","Chancho","364.0","374280.0",1631,844,787,965,568,397,511,347,164,"5","2","1","1","1","5.0","1.0","2.0","1.0","1.0"
"ranchi","jharkhand","Doranda","364.0","374281.0",1934,982,952,1176,682,494,1204,612,592,"4","1","1","1","1","5.0","1.0","2.0","1.0","1.0"
"ranchi","jharkhand","Karge","364.0","374282.0",1485,741,744,754,457,297,719,358,361,"6","1","2","2","1","5.0","1.0","2.0","1.0","1.0"
"ranchi","jharkhand","Baid Khijri","364.0","374283.0",313,162,151,183,113,70,171,84,87,"8","3","1","3","1","5.0","1.0","2.0","1.0","1.0"
"ranchi","jharkhand","Bilti","364.0","374284.0",1341,677,664,748,423,325,593,319,274,"7","1","2","3","1","5.0","1.0","2.0","1.0","1.0"
"ranchi","jharkhand","Chankapi","364.0","374285.0",998,509,489,530,324,206,489,252,237,"4","1","1","1","1","5.0","1.0","2.0","1.0","1.0"
"ranchi","jharkhand","Sero","364.0","374286.0",2278,1145,1133,1064,630,434,1499,742,757,"6","1","1","3","1","5.0","1.0","2.0","1.0","1.0"
"ranchi","jharkhand","Karkari","364.0","374287.0",2274,1155,1119,1386,817,569,1299,662,637,"5","1","1","2","1","5.0","1.0","2.0","1.0","1.0"
"ranchi","jharkhand","Khanrdiuri","364.0","374288.0",1238,607,631,689,381,308,987,479,508,"6","1","2","2","1","5.0","1.0","2.0","1.0","1.0"
"ranchi","jharkhand","Bhainsadon","364.0","374289.0",508,258,250,259,155,104,308,153,155,"5","1","2","1","1","5.0","1.0","2.0","1.0","1.0"
"ranchi","jharkhand","Masiatu","364.0","374290.0",643,331,312,296,178,118,307,153,154,"6","2","2","1","1","5.0","1.0","2.0","1.0","1.0"
"ranchi","jharkhand","Darsita","364.0","374291.0",566,307,259,333,203,130,231,114,117,"6","2","2","1","1","8.0","2.0","2.0","3.0","1.0"
"ranchi","jharkhand","Paharkanrriya","364.0","374292.0",1438,731,707,768,459,309,987,501,486,"5","1","2","1","1","5.0","1.0","2.0","1.0","1.0"
"ranchi","jharkhand","Khukhra","364.0","374293.0",5527,2877,2650,3034,1866,1168,3250,1742,1508,"5","1","2","1","1","5.0","1.0","2.0","1.0","1.0"
"ranchi","jharkhand","Chachkapi","364.0","374294.0",2348,1211,1137,1235,744,491,1146,622,524,"6","1","1","3","1","5.0","1.0","2.0","1.0","1.0"
"ranchi","jharkhand","Tuko","364.0","374295.0",2270,1169,1101,1297,764,533,1050,607,443,"5","1","2","1","1","5.0","1.0","2.0","1.0","1.0"
"ranchi","jharkhand","Ghaghra","364.0","374296.0",3464,1802,1662,1858,1124,734,1470,843,627,"7","1","2","3","1","4.0","1.0","1.0","1.0","1.0"
"ranchi","jharkhand","Kadojora","364.0","374297.0",429,214,215,284,156,128,148,104,44,"5","2","1","1","1","5.0","1.0","2.0","1.0","1.0"
"ranchi","jharkhand","Hathu","364.0","374298.0",691,363,328,404,251,153,157,138,19,"8","2","2","3","1","5.0","1.0","2.0","1.0","1.0"
"ranchi","jharkhand","Dumardon","364.0","374299.0",437,223,214,256,139,117,122,95,27,"4","1","1","1","1","5.0","1.0","2.0","1.0","1.0"
"ranchi","jharkhand","Sijhuwa","364.0","374300.0",508,248,260,315,177,138,142,115,27,"6","2","2","1","1","6.0","1.0","3.0","1.0","1.0"
"ranchi","jharkhand","Konkre","364.0","374303.0",466,241,225,249,148,101,230,120,110,"4","1","1","1","1","5.0","1.0","2.0","1.0","1.0"
"ranchi","jharkhand","Singarsarai","364.0","374304.0",353,180,173,228,133,95,168,84,84,"5","1","2","1","1","5.0","1.0","2.0","1.0","1.0"
"ranchi","jharkhand","Kairo","364.0","374305.0",931,484,447,539,307,232,361,209,152,"4","1","1","1","1","5.0","1.0","2.0","1.0","1.0"
"ranchi","jharkhand","Asro","364.0","374306.0",1139,566,573,641,368,273,370,266,104,"4","1","1","1","1","5.0","1.0","2.0","1.0","1.0"
"ranchi","jharkhand","Lamkara","364.0","374307.0",665,340,325,382,222,160,316,170,146,"5","1","1","2","1","5.0","1.0","2.0","1.0","1.0"
"ranchi","jharkhand","Hutri","364.0","374308.0",520,268,252,276,157,119,248,126,122,"6","1","1","3","1","6.0","1.0","3.0","1.0","1.0"
"ranchi","jharkhand","Kerabhita","364.0","374309.0",1147,572,575,590,352,238,260,203,57,"4","1","1","1","1","5.0","1.0","2.0","1.0","1.0"
"ranchi","jharkhand","Dumri","364.0","374311.0",457,232,225,258,149,109,241,126,115,"6","2","2","1","1","5.0","1.0","2.0","1.0","1.0"
"ranchi","jharkhand","Roghadihpatratoli","364.0","374312.0",1112,557,555,547,319,228,574,273,301,"4","1","1","1","1","5.0","1.0","2.0","1.0","1.0"
"ranchi","jharkhand","Nehalukapariya","364.0","374313.0",3344,1698,1646,1593,905,688,1922,1031,891,"5","2","1","1","1","5.0","1.0","2.0","1.0","1.0"
"ranchi","jharkhand","Pandra","364.0","374314.0",824,410,414,435,265,170,460,242,218,"4","1","1","1","1","6.0","1.0","3.0","1.0","1.0"
"ranchi","jharkhand","Hutar","364.0","374315.0",666,333,333,369,215,154,335,159,176,"5","1","2","1","1","4.0","1.0","1.0","1.0","1.0"
"ranchi","jharkhand","Harhanji","364.0","374316.0",736,375,361,380,231,149,192,146,46,"5","2","1","1","1","4.0","1.0","1.0","1.0","1.0"
"ranchi","jharkhand","Bhasnanda","364.0","374317.0",484,240,244,190,116,74,165,109,56,"4","1","1","1","1","5.0","1.0","2.0","1.0","1.0"
"ranchi","jharkhand","Boda","364.0","374318.0",555,292,263,296,192,104,227,127,100,"5","2","1","1","1","6.0","3.0","1.0","1.0","1.0"
"ranchi","jharkhand","Jamuni","364.0","374319.0",355,180,175,211,122,89,194,102,92,"5","1","2","1","1","5.0","1.0","2.0","1.0","1.0"
"ranchi","jharkhand","Jahanabaj","364.0","374320.0",1346,675,671,708,418,290,553,336,217,"4","1","1","1","1","5.0","1.0","2.0","1.0","1.0"
"ranchi","jharkhand","Rogo","364.0","374321.0",779,387,392,555,299,256,361,194,167,"6","1","3","1","1","5.0","1.0","2.0","1.0","1.0"
"ranchi","jharkhand","Khirda","364.0","374322.0",859,413,446,411,218,193,512,251,261,"4","1","1","1","1","6.0","1.0","3.0","1.0","1.0"
"ranchi","jharkhand","Charma","364.0","374323.0",605,292,313,302,160,142,303,153,150,"5","2","1","1","1","5.0","1.0","2.0","1.0","1.0"
"ranchi","jharkhand","Mahru","364.0","374324.0",687,357,330,414,244,170,455,235,220,"4","1","1","1","1","5.0","1.0","2.0","1.0","1.0"
"ranchi","jharkhand","Nagri","364.0","374325.0",796,386,410,421,244,177,374,200,174,"5","2","1","1","1","5.0","1.0","2.0","1.0","1.0"
"ranchi","jharkhand","Ita","364.0","374326.0",1600,800,800,825,469,356,834,432,402,"5","2","1","1","1","5.0","1.0","2.0","1.0","1.0"
"ranchi","jharkhand","Childiri","364.0","374327.0",1445,732,713,732,443,289,805,410,395,"5","2","1","1","1","5.0","1.0","2.0","1.0","1.0"
"ranchi","jharkhand","Dighiya","364.0","374328.0",2754,1375,1379,1575,906,669,1990,1002,988,"7","2","2","2","1","4.0","1.0","1.0","1.0","1.0"
"ranchi","jharkhand","Karanji","364.0","374329.0",3119,1593,1526,1998,1114,884,1308,748,560,"6","1","2","1","2","5.0","1.0","2.0","1.0","1.0"
"ranchi","jharkhand","Khatanga","364.0","374330.0",2148,1111,1037,1452,837,615,877,570,307,"6","2","2","1","1","6.0","1.0","3.0","1.0","1.0"
"ranchi","jharkhand","Kudarko","364.0","374331.0",1331,642,689,849,470,379,707,367,340,"6","1","2","2","1","5.0","1.0","2.0","1.0","1.0"
"ranchi","jharkhand","Tengriya","364.0","374332.0",1278,643,635,732,444,288,564,316,248,"6","2","2","1","1","4.0","1.0","1.0","1.0","1.0"
"ranchi","jharkhand","Banri","364.0","374333.0",584,287,297,401,210,191,426,203,223,"5","1","2","1","1","5.0","1.0","2.0","1.0","1.0"
"ranchi","jharkhand","Donrkanrriya","364.0","374334.0",615,314,301,360,208,152,332,164,168,"6","1","2","2","1","5.0","1.0","2.0","1.0","1.0"
"ranchi","jharkhand","Balirampur","364.0","374335.0",741,365,376,371,216,155,393,199,194,"5","1","1","2","1","5.0","1.0","2.0","1.0","1.0"
"ranchi","jharkhand","Chanho","364.0","374336.0",592,320,272,360,236,124,236,132,104,"6","3","1","1","1","5.0","1.0","2.0","1.0","1.0"
"ranchi","jharkhand","Chapadih","364.0","374337.0",339,169,170,211,119,92,155,71,84,"7","1","2","3","1","5.0","1.0","2.0","1.0","1.0"
"ranchi","jharkhand","Narkopi","364.0","374338.0",1556,787,769,865,507,358,727,374,353,"6","2","2","1","1","5.0","1.0","2.0","1.0","1.0"
"ranchi","jharkhand","Makunda","364.0","374339.0",1109,548,561,713,405,308,597,289,308,"6","1","2","2","1","6.0","3.0","1.0","1.0","1.0"
"ranchi","jharkhand","Tutlo","364.0","374340.0",1125,536,589,652,347,305,517,247,270,"9","1","2","3","3","5.0","1.0","2.0","1.0","1.0"
"ranchi","jharkhand","Ita","364.0","374341.0",1135,580,555,593,348,245,518,268,250,"8","1","2","3","2","5.0","1.0","2.0","1.0","1.0"
"ranchi","jharkhand","Kotpali","364.0","374342.0",590,312,278,363,219,144,106,100,6,"7","2","1","3","1","5.0","1.0","2.0","1.0","1.0"
"ranchi","jharkhand","Murto","364.0","374343.0",2063,1053,1010,1300,742,558,1103,548,555,"7","3","2","1","1","5.0","1.0","2.0","1.0","1.0"
"ranchi","jharkhand","Irri","364.0","374344.0",1191,609,582,774,438,336,651,351,300,"7","2","2","2","1","7.0","3.0","2.0","1.0","1.0"
"ranchi","jharkhand","Mahugaon","364.0","374345.0",1087,568,519,547,325,222,838,450,388,"7","1","2","3","1","5.0","1.0","2.0","1.0","1.0"
"ranchi","jharkhand","Tero","364.0","374346.0",2768,1441,1327,1440,838,602,1528,769,759,"8","2","2","3","1","5.0","1.0","2.0","1.0","1.0"
"ranchi","jharkhand","Rora Alias Garhatoli","364.0","374347.0",730,389,341,443,269,174,193,165,28,"7","2","3","1","1","5.0","1.0","2.0","1.0","1.0"
"ranchi","jharkhand","Chachkapi","364.0","374348.0",3363,1694,1669,1615,981,634,1483,812,671,"5","1","2","1","1","4.0","1.0","1.0","1.0","1.0"
"ranchi","jharkhand","Duru","364.0","374349.0",702,353,349,363,212,151,457,255,202,"6","2","2","1","1","5.0","1.0","2.0","1.0","1.0"
"ranchi","jharkhand","Changani","364.0","374350.0",1297,634,663,757,447,310,505,275,230,"6","2","2","1","1","5.0","1.0","2.0","1.0","1.0"
"ranchi","jharkhand","Tikratoli","364.0","374351.0",1120,585,535,759,429,330,378,271,107,"5","1","2","1","1","5.0","1.0","2.0","1.0","1.0"
"ranchi","jharkhand","Nari","364.0","374352.0",2169,1083,1086,1250,734,516,1187,587,600,"7","2","2","2","1","5.0","1.0","2.0","1.0","1.0"
"ranchi","jharkhand","Puriya","364.0","374355.0",4413,2210,2203,2535,1468,1067,2315,1223,1092,"6","2","2","1","1","5.0","1.0","2.0","1.0","1.0"
"ranchi","jharkhand","Bero","364.0","374356.0",7193,3517,3676,5016,2591,2425,3038,1713,1325,"10","1","3","3","3","6.0","1.0","3.0","1.0","1.0"
"ranchi","jharkhand","Baridih","364.0","374357.0",1078,631,447,729,485,244,490,246,244,"6","2","2","1","1","4.0","1.0","1.0","1.0","1.0"
"ranchi","jharkhand","Hariharpur Jamtoli","364.0","374358.0",2408,1228,1180,1333,780,553,1208,619,589,"5","2","1","1","1","5.0","1.0","2.0","1.0","1.0"
"ranchi","jharkhand","Muramu","364.0","374359.0",783,393,390,380,239,141,399,195,204,"5","2","1","1","1","5.0","1.0","2.0","1.0","1.0"
"ranchi","jharkhand","Jariya","364.0","374360.0",2154,1095,1059,1423,832,591,1031,542,489,"5","1","2","1","1","5.0","1.0","2.0","1.0","1.0"
"ranchi","jharkhand","Katarmali","364.0","374361.0",886,432,454,445,262,183,506,246,260,"6","2","2","1","1","4.0","1.0","1.0","1.0","1.0"
"ranchi","jharkhand","Tengriya","364.0","374362.0",1127,592,535,690,423,267,776,403,373,"5","1","2","1","1","5.0","1.0","2.0","1.0","1.0"
"ranchi","jharkhand","Masu","364.0","374363.0",496,263,233,282,166,116,206,104,102,"4","1","1","1","1","5.0","1.0","2.0","1.0","1.0"
"ranchi","jharkhand","Hulsi","364.0","374364.0",425,213,212,230,132,98,200,96,104,"4","1","1","1","1","7.0","3.0","2.0","1.0","1.0"
"ranchi","jharkhand","Dola","364.0","374365.0",426,219,207,194,113,81,204,115,89,"5","1","2","1","1","6.0","1.0","3.0","1.0","1.0"
"ranchi","jharkhand","Sugda","364.0","374366.0",539,264,275,283,175,108,219,156,63,"5","1","2","1","1","7.0","3.0","2.0","1.0","1.0"
"ranchi","jharkhand","Sauka","364.0","374367.0",556,287,269,256,158,98,357,180,177,"4","1","1","1","1","6.0","1.0","3.0","1.0","1.0"
"ranchi","jharkhand","Harmu","364.0","374368.0",388,192,196,175,110,65,295,145,150,"4","1","1","1","1","5.0","1.0","2.0","1.0","1.0"
"ranchi","jharkhand","Lawagain","364.0","374369.0",411,219,192,186,114,72,194,93,101,"4","1","1","1","1","7.0","3.0","2.0","1.0","1.0"
"ranchi","jharkhand","Chinaro","364.0","374370.0",523,256,267,249,145,104,240,118,122,"4","1","1","1","1","4.0","1.0","1.0","1.0","1.0"
"ranchi","jharkhand","Puriya","364.0","374371.0",733,376,357,420,234,186,321,167,154,"5","1","2","1","1","5.0","1.0","2.0","1.0","1.0"
"ranchi","jharkhand","Lupunga","364.0","374372.0",404,209,195,153,108,45,239,122,117,"6","2","2","1","1","5.0","1.0","2.0","1.0","1.0"
"ranchi","jharkhand","Khambha","364.0","374373.0",342,178,164,193,107,86,162,85,77,"5","1","2","1","1","6.0","1.0","1.0","1.0","3.0"
"ranchi","jharkhand","Ranidih","364.0","374374.0",97,51,46,59,36,23,48,25,23,"4","1","1","1","1","6.0","1.0","3.0","1.0","1.0"
"ranchi","jharkhand","Kuli","364.0","374375.0",3208,1577,1631,1827,1061,766,1533,748,785,"5","1","2","1","1","5.0","1.0","2.0","1.0","1.0"
"ranchi","jharkhand","Bhandra","364.0","374376.0",1519,781,738,918,559,359,926,472,454,"6","2","2","1","1","5.0","1.0","2.0","1.0","1.0"
"ranchi","jharkhand","Tilaksuti","364.0","374377.0",749,380,369,462,285,177,417,203,214,"6","1","3","1","1","6.0","2.0","2.0","1.0","1.0"
"ranchi","jharkhand","Malar","364.0","374378.0",641,341,300,429,246,183,229,160,69,"6","1","3","1","1","5.0","1.0","2.0","1.0","1.0"
"ranchi","jharkhand","Bindhani","364.0","374379.0",621,324,297,307,188,119,270,171,99,"6","2","2","1","1","5.0","1.0","2.0","1.0","1.0"
"ranchi","jharkhand","Chachgura","364.0","374380.0",1359,707,652,773,486,287,718,397,321,"5","1","2","1","1","5.0","1.0","2.0","1.0","1.0"
"ranchi","jharkhand","Makunda","364.0","374383.0",698,348,350,460,255,205,347,186,161,"5","2","1","1","1","4.0","1.0","1.0","1.0","1.0"
"ranchi","jharkhand","Moro","364.0","374384.0",1683,855,828,991,588,403,723,435,288,"6","2","2","1","1","6.0","1.0","2.0","1.0","2.0"
"ranchi","jharkhand","Itkithakurgoan","364.0","374385.0",12174,6141,6033,8713,4660,4053,3748,2745,1003,"9","1","2","3","3","5.0","1.0","2.0","1.0","1.0"
"ranchi","jharkhand","Turguru","364.0","374386.0",1931,996,935,1299,744,555,798,461,337,"10","2","2","3","3","5.0","1.0","2.0","1.0","1.0"
"ranchi","jharkhand","Kundi","364.0","374387.0",2820,1447,1373,1753,1031,722,1028,672,356,"8","2","2","3","1","5.0","1.0","2.0","1.0","1.0"
"ranchi","jharkhand","Targari","364.0","374388.0",3000,1420,1580,2120,1033,1087,810,624,186,"6","1","2","1","2","5.0","1.0","2.0","1.0","1.0"
"ranchi","jharkhand","Malti","364.0","374389.0",1975,1030,945,1283,741,542,748,473,275,"6","1","2","1","2","5.0","1.0","2.0","1.0","1.0"
"ranchi","jharkhand","Palma","364.0","374390.0",908,436,472,571,326,245,426,208,218,"5","1","2","1","1","4.0","1.0","1.0","1.0","1.0"
"ranchi","jharkhand","Semra","364.0","374392.0",921,449,472,563,302,261,417,238,179,"6","1","3","1","1","5.0","1.0","2.0","1.0","1.0"
"ranchi","jharkhand","Baridih","364.0","374393.0",1304,649,655,725,431,294,617,320,297,"5","1","2","1","1","5.0","1.0","2.0","1.0","1.0"
"ranchi","jharkhand","Gara","364.0","374395.0",570,299,271,259,150,109,317,174,143,"4","1","1","1","1","6.0","1.0","3.0","1.0","1.0"
"ranchi","jharkhand","Lodhma","364.0","374396.0",582,296,286,291,165,126,354,179,175,"5","2","1","1","1","5.0","1.0","2.0","1.0","1.0"
"ranchi","jharkhand","Dimba","364.0","374397.0",1381,642,739,610,325,285,648,337,311,"4","1","1","1","1","5.0","1.0","2.0","1.0","1.0"
"ranchi","jharkhand","Dolaicha","364.0","374398.0",2360,1196,1164,1249,740,509,1116,576,540,"4","1","1","1","1","4.0","1.0","1.0","1.0","1.0"
"ranchi","jharkhand","Armalatdag","364.0","374399.0",1531,755,776,796,465,331,719,355,364,"4","1","1","1","1","4.0","1.0","1.0","1.0","1.0"
"ranchi","jharkhand","Biramkel","364.0","374400.0",663,328,335,268,158,110,375,183,192,"4","1","1","1","1","5.0","1.0","2.0","1.0","1.0"
"ranchi","jharkhand","Pandu","364.0","374401.0",705,338,367,317,190,127,394,198,196,"4","1","1","1","1","5.0","1.0","2.0","1.0","1.0"
"ranchi","jharkhand","Koinara","364.0","374402.0",1301,605,696,556,323,233,731,334,397,"4","1","1","1","1","6.0","1.0","2.0","1.0","2.0"
"ranchi","jharkhand","Danekera","364.0","374403.0",1764,849,915,730,439,291,1042,509,533,"4","1","1","1","1","5.0","1.0","2.0","1.0","1.0"
"ranchi","jharkhand","Sukurhutu","364.0","374404.0",472,236,236,271,157,114,270,144,126,"4","1","1","1","1","5.0","1.0","2.0","1.0","1.0"
"ranchi","jharkhand","Parsa","364.0","374405.0",514,264,250,294,173,121,248,138,110,"6","2","2","1","1","4.0","1.0","1.0","1.0","1.0"
"ranchi","jharkhand","Katingkela","364.0","374406.0",1055,519,536,575,338,237,590,284,306,"4","1","1","1","1","5.0","1.0","2.0","1.0","1.0"
"ranchi","jharkhand","Sarangloya","364.0","374407.0",651,317,334,370,201,169,329,168,161,"6","1","1","3","1","4.0","1.0","1.0","1.0","1.0"
"ranchi","jharkhand","Raitoli","364.0","374408.0",585,274,311,297,170,127,321,144,177,"4","1","1","1","1","5.0","1.0","2.0","1.0","1.0"
"ranchi","jharkhand","Jataloya","364.0","374409.0",958,463,495,523,301,222,535,255,280,"5","2","1","1","1","5.0","1.0","2.0","1.0","1.0"
"ranchi","jharkhand","Sapukera","364.0","374410.0",1074,573,501,730,437,293,514,327,187,"5","1","2","1","1","4.0","1.0","1.0","1.0","1.0"
"ranchi","jharkhand","Lapung","364.0","374411.0",903,460,443,543,306,237,443,265,178,"5","1","2","1","1","5.0","1.0","2.0","1.0","1.0"
"ranchi","jharkhand","Gateatoli","364.0","374412.0",616,293,323,253,149,104,349,167,182,"4","1","1","1","1","5.0","1.0","2.0","1.0","1.0"
"ranchi","jharkhand","Sohagi","364.0","374413.0",411,203,208,247,145,102,217,106,111,"5","2","1","1","1","5.0","1.0","2.0","1.0","1.0"
"ranchi","jharkhand","Lalganj","364.0","374414.0",1117,559,558,600,353,247,666,324,342,"4","1","1","1","1","5.0","1.0","2.0","1.0","1.0"
"ranchi","jharkhand","Gari","364.0","374415.0",431,189,242,215,118,97,285,120,165,"4","1","1","1","1","5.0","1.0","2.0","1.0","1.0"
"ranchi","jharkhand","Lete","364.0","374416.0",335,173,162,171,101,70,157,81,76,"4","1","1","1","1","5.0","1.0","2.0","1.0","1.0"
"ranchi","jharkhand","Lohagara","364.0","374417.0",313,159,154,107,67,40,188,88,100,"4","1","1","1","1","5.0","1.0","2.0","1.0","1.0"
"ranchi","jharkhand","Pabira","364.0","374418.0",890,430,460,400,235,165,475,226,249,"5","1","2","1","1","5.0","1.0","2.0","1.0","1.0"
"ranchi","jharkhand","Baraidih","364.0","374419.0",403,213,190,190,116,74,239,123,116,"4","1","1","1","1","5.0","1.0","2.0","1.0","1.0"
"ranchi","jharkhand","Bakronda","364.0","374420.0",1891,952,939,1022,601,421,940,483,457,"5","2","1","1","1","6.0","1.0","3.0","1.0","1.0"
"ranchi","jharkhand","Buruhatu","364.0","374564.0",1321,663,658,528,363,165,732,369,363,"4","1","1","1","1","5.0","1.0","2.0","1.0","1.0"
"ranchi","jharkhand","Peyakuli","364.0","374566.0",621,307,314,262,160,102,348,173,175,"4","1","1","1","1","5.0","1.0","2.0","1.0","1.0"
"ranchi","jharkhand","Gumti","364.0","374567.0",672,341,331,207,125,82,383,186,197,"4","1","1","1","1","5.0","1.0","2.0","1.0","1.0"
"ranchi","jharkhand","Chatamsal","364.0","374568.0",415,215,200,149,97,52,247,122,125,"4","1","1","1","1","5.0","2.0","1.0","1.0","1.0"
"ranchi","jharkhand","Rabo","364.0","374569.0",588,283,305,202,133,69,364,172,192,"4","1","1","1","1","5.0","1.0","2.0","1.0","1.0"
"ranchi","jharkhand","Kitadih","364.0","374570.0",152,79,73,68,52,16,88,39,49,"4","1","1","1","1","6.0","2.0","2.0","1.0","1.0"
"ranchi","jharkhand","Taladih","364.0","374571.0",588,289,299,179,109,70,354,186,168,"4","1","1","1","1","5.0","1.0","2.0","1.0","1.0"
"ranchi","jharkhand","Burudih","364.0","374572.0",209,103,106,113,71,42,113,51,62,"5","2","1","1","1","5.0","2.0","1.0","1.0","1.0"
"ranchi","jharkhand","Banki","364.0","374574.0",297,153,144,114,75,39,184,88,96,"4","1","1","1","1","6.0","2.0","2.0","1.0","1.0"
"ranchi","jharkhand","Mankidih","364.0","374575.0",1430,738,692,738,468,270,639,425,214,"7","2","1","3","1","6.0","2.0","2.0","1.0","1.0"
"ranchi","jharkhand","Baghai","364.0","374577.0",1150,589,561,449,306,143,903,467,436,"4","1","1","1","1","6.0","2.0","2.0","1.0","1.0"
"ranchi","jharkhand","Papirda","364.0","374578.0",311,154,157,122,72,50,238,117,121,"4","1","1","1","1","5.0","1.0","2.0","1.0","1.0"
"ranchi","jharkhand","Tamrana","364.0","374579.0",496,244,252,135,93,42,420,205,215,"4","1","1","1","1","5.0","1.0","2.0","1.0","1.0"
"ranchi","jharkhand","Patsahidih","364.0","374580.0",785,417,368,480,310,170,525,272,253,"5","1","2","1","1","5.0","1.0","2.0","1.0","1.0"
"ranchi","jharkhand","Dimra","364.0","374582.0",469,234,235,247,145,102,287,129,158,"6","3","1","1","1","7.0","2.0","2.0","2.0","1.0"
"ranchi","jharkhand","Kuehru","364.0","374583.0",294,151,143,153,90,63,170,84,86,"4","1","1","1","1","7.0","2.0","2.0","2.0","1.0"
"ranchi","jharkhand","Lankiya","364.0","374584.0",528,255,273,272,155,117,334,166,168,"5","2","1","1","1","7.0","2.0","2.0","2.0","1.0"
"ranchi","jharkhand","Dongidih","364.0","374585.0",675,339,336,343,211,132,451,240,211,"4","1","1","1","1","5.0","1.0","2.0","1.0","1.0"
"ranchi","jharkhand","Chipibandhdih","364.0","374586.0",808,420,388,448,282,166,592,314,278,"5","2","1","1","1","5.0","1.0","2.0","1.0","1.0"
"ranchi","jharkhand","Degadari","364.0","374587.0",660,321,339,349,215,134,456,220,236,"5","2","1","1","1","6.0","2.0","2.0","1.0","1.0"
"ranchi","jharkhand","Jhatgaon","364.0","374588.0",787,391,396,421,254,167,459,239,220,"4","1","1","1","1","6.0","2.0","2.0","1.0","1.0"
"ranchi","jharkhand","Kundla","364.0","374589.0",973,493,480,472,296,176,551,281,270,"6","3","1","1","1","5.0","1.0","2.0","1.0","1.0"
"ranchi","jharkhand","Timpur","364.0","374590.0",1168,574,594,551,348,203,661,332,329,"4","1","1","1","1","5.0","1.0","2.0","1.0","1.0"
"ranchi","jharkhand","Lohri","364.0","374591.0",706,375,331,380,258,122,424,221,203,"5","2","1","1","1","5.0","1.0","2.0","1.0","1.0"
"ranchi","jharkhand","Londra","364.0","374592.0",712,354,358,327,209,118,333,186,147,"5","2","1","1","1","8.0","2.0","2.0","3.0","1.0"
"ranchi","jharkhand","Gumandih","364.0","374594.0",760,397,363,343,231,112,471,230,241,"4","1","1","1","1","5.0","1.0","2.0","1.0","1.0"
"ranchi","jharkhand","Kutachauli","364.0","374595.0",119,58,61,59,43,16,75,33,42,"5","2","1","1","1","6.0","2.0","2.0","1.0","1.0"
"ranchi","jharkhand","Udaidih","364.0","374596.0",239,119,120,145,90,55,152,71,81,"5","2","1","1","1","5.0","1.0","2.0","1.0","1.0"
"ranchi","jharkhand","Kothadih","364.0","374597.0",1170,582,588,756,437,319,646,317,329,"5","2","1","1","1","5.0","1.0","2.0","1.0","1.0"
"ranchi","jharkhand","Toranga","364.0","374598.0",239,124,115,139,93,46,126,64,62,"5","2","1","1","1","5.0","1.0","2.0","1.0","1.0"
"ranchi","jharkhand","Ulidih","364.0","374599.0",1515,752,763,761,477,284,760,406,354,"5","2","1","1","1","6.0","2.0","2.0","1.0","1.0"
"ranchi","jharkhand","Barnian","364.0","374600.0",264,134,130,148,93,55,175,84,91,"5","2","1","1","1","5.0","1.0","2.0","1.0","1.0"
"ranchi","jharkhand","Rugri","364.0","374601.0",1422,724,698,826,505,321,796,384,412,"5","2","1","1","1","5.0","1.0","2.0","1.0","1.0"
"ranchi","jharkhand","Madhudih","364.0","374602.0",334,174,160,182,106,76,191,93,98,"5","2","1","1","1","6.0","2.0","2.0","1.0","1.0"
"ranchi","jharkhand","Gutibaru","364.0","374604.0",530,251,279,239,144,95,319,153,166,"5","2","1","1","1","5.0","1.0","2.0","1.0","1.0"
"ranchi","jharkhand","Roladih","364.0","374607.0",677,337,340,405,250,155,465,235,230,"4","1","1","1","1","6.0","2.0","2.0","1.0","1.0"
"ranchi","jharkhand","Japno","364.0","374608.0",923,463,460,446,283,163,564,281,283,"4","1","1","1","1","5.0","1.0","2.0","1.0","1.0"
"ranchi","jharkhand","Jargo","364.0","374609.0",1693,859,834,740,463,277,1201,632,569,"4","1","1","1","1","5.0","1.0","2.0","1.0","1.0"
"ranchi","jharkhand","Bususingu","364.0","374610.0",462,210,252,254,145,109,189,104,85,"4","1","1","1","1","7.0","2.0","2.0","2.0","1.0"
"ranchi","jharkhand","Burudih","364.0","374611.0",399,212,187,183,123,60,227,115,112,"4","1","1","1","1","5.0","1.0","2.0","1.0","1.0"
"ranchi","jharkhand","Domodih","364.0","374612.0",638,315,323,350,196,154,440,214,226,"4","1","1","1","1","5.0","1.0","2.0","1.0","1.0"
"ranchi","jharkhand","Chirudih","364.0","374613.0",859,446,413,520,311,209,453,221,232,"4","1","1","1","1","5.0","1.0","2.0","1.0","1.0"
"ranchi","jharkhand","Mardhan","364.0","374615.0",1351,662,689,600,372,228,591,346,245,"4","1","1","1","1","5.0","1.0","2.0","1.0","1.0"
"ranchi","jharkhand","Domra","364.0","374617.0",762,400,362,478,313,165,384,186,198,"4","1","1","1","1","5.0","1.0","2.0","1.0","1.0"
"ranchi","jharkhand","Kokadih","364.0","374618.0",1108,546,562,585,371,214,648,315,333,"6","3","1","1","1","5.0","1.0","2.0","1.0","1.0"
"ranchi","jharkhand","Jogaisigu","364.0","374619.0",765,387,378,445,278,167,413,212,201,"6","3","1","1","1","5.0","1.0","2.0","1.0","1.0"
"ranchi","jharkhand","Malhan Bhuidih","364.0","374620.0",2988,1535,1453,1572,966,606,1523,863,660,"4","1","1","1","1","6.0","2.0","2.0","1.0","1.0"
"ranchi","jharkhand","Gango","364.0","374621.0",1167,590,577,600,385,215,705,358,347,"4","1","1","1","1","5.0","1.0","2.0","1.0","1.0"
"ranchi","jharkhand","Koijanigurha","364.0","374622.0",654,321,333,357,218,139,365,172,193,"4","1","1","1","1","5.0","1.0","2.0","1.0","1.0"
"ranchi","jharkhand","Kubasal","364.0","374623.0",1359,707,652,695,420,275,692,386,306,"6","2","2","1","1","5.0","1.0","2.0","1.0","1.0"
"ranchi","jharkhand","Bhuradih","364.0","374624.0",1112,587,525,594,375,219,692,356,336,"5","2","1","1","1","6.0","2.0","2.0","1.0","1.0"
"ranchi","jharkhand","Lodhma","364.0","374625.0",886,438,448,357,229,128,517,257,260,"4","1","1","1","1","8.0","3.0","1.0","3.0","1.0"
"ranchi","jharkhand","Darida","364.0","374628.0",513,269,244,297,202,95,294,149,145,"4","1","1","1","1","5.0","1.0","2.0","1.0","1.0"
"ranchi","jharkhand","Rargaon","364.0","374629.0",2450,1203,1247,1462,814,648,977,611,366,"6","2","2","1","1","5.0","1.0","2.0","1.0","1.0"
"ranchi","jharkhand","Hurundih","364.0","374630.0",1280,653,627,756,470,286,402,358,44,"4","1","1","1","1","6.0","2.0","2.0","1.0","1.0"
"ranchi","jharkhand","Baburamdih","364.0","374631.0",1483,769,714,859,534,325,657,377,280,"4","1","1","1","1","7.0","2.0","2.0","2.0","1.0"
"ranchi","jharkhand","Palna","364.0","374632.0",1579,806,773,854,530,324,931,485,446,"4","1","1","1","1","6.0","2.0","2.0","1.0","1.0"
"ranchi","jharkhand","Haranlohar","364.0","374633.0",2054,1085,969,943,605,338,1187,628,559,"4","1","1","1","1","5.0","1.0","2.0","1.0","1.0"
"ranchi","jharkhand","Kurchudih","364.0","374634.0",637,333,304,301,188,113,344,154,190,"4","1","1","1","1","5.0","1.0","2.0","1.0","1.0"
"ranchi","jharkhand","Mankidih","364.0","374635.0",1114,569,545,548,348,200,617,305,312,"4","1","1","1","1","5.0","1.0","2.0","1.0","1.0"
"ranchi","jharkhand","Birdih","364.0","374636.0",1430,711,719,808,485,323,804,377,427,"5","2","1","1","1","5.0","1.0","2.0","1.0","1.0"
"ranchi","jharkhand","Karamdiri","364.0","374637.0",815,416,399,399,261,138,468,229,239,"4","1","1","1","1","5.0","1.0","2.0","1.0","1.0"
"ranchi","jharkhand","Barlanga","364.0","374638.0",1883,946,937,950,614,336,1157,565,592,"4","1","1","1","1","5.0","1.0","2.0","1.0","1.0"
"ranchi","jharkhand","Ichadih","364.0","374639.0",1617,801,816,955,579,376,624,404,220,"5","2","1","1","1","5.0","1.0","2.0","1.0","1.0"
"ranchi","jharkhand","Birgaon","364.0","374640.0",3565,1803,1762,1902,1201,701,1840,986,854,"5","2","1","1","1","5.0","1.0","2.0","1.0","1.0"
"ranchi","jharkhand","Sarjamdih","364.0","374641.0",4477,2334,2143,1937,1281,656,2323,1185,1138,"4","1","1","1","1","5.0","1.0","2.0","1.0","1.0"
"ranchi","jharkhand","Jegodakai","364.0","374642.0",677,348,329,326,207,119,352,179,173,"4","1","1","1","1","5.0","1.0","2.0","1.0","1.0"
"ranchi","jharkhand","Ragrabaranga","364.0","374643.0",1408,709,699,812,486,326,959,484,475,"4","1","1","1","1","5.0","1.0","2.0","1.0","1.0"
"ranchi","jharkhand","Kurkutia","364.0","374644.0",1820,911,909,880,564,316,1150,569,581,"4","1","1","1","1","5.0","1.0","2.0","1.0","1.0"
"ranchi","jharkhand","Barukande","364.0","374645.0",708,361,347,376,238,138,398,204,194,"4","1","1","1","1","5.0","1.0","2.0","1.0","1.0"
"ranchi","jharkhand","Jiling Sereng","364.0","374646.0",1114,563,551,659,414,245,486,296,190,"4","1","1","1","1","5.0","1.0","2.0","1.0","1.0"
"ranchi","jharkhand","Geredih","364.0","374647.0",667,338,329,346,212,134,403,205,198,"4","1","1","1","1","5.0","1.0","2.0","1.0","1.0"
"ranchi","jharkhand","Ulilohar","364.0","374648.0",2734,1330,1404,1553,953,600,1532,811,721,"5","2","1","1","1","5.0","1.0","2.0","1.0","1.0"
"ranchi","jharkhand","Jamdih","364.0","374649.0",934,451,483,535,315,220,290,237,53,"4","1","1","1","1","4.0","1.0","1.0","1.0","1.0"
"ranchi","jharkhand","Dimbujarda","364.0","374650.0",1962,1015,947,962,605,357,1188,605,583,"7","2","1","3","1","5.0","1.0","2.0","1.0","1.0"
"ranchi","jharkhand","Daruara","364.0","374651.0",394,199,195,226,145,81,260,131,129,"5","1","1","2","1","7.0","1.0","2.0","3.0","1.0"
"ranchi","jharkhand","Haradih","364.0","374652.0",480,257,223,262,179,83,125,121,4,"4","1","1","1","1","5.0","1.0","2.0","1.0","1.0"
"ranchi","jharkhand","Badla","364.0","374653.0",1102,554,548,627,373,254,595,292,303,"4","1","1","1","1","5.0","1.0","2.0","1.0","1.0"
"ranchi","jharkhand","Chogadih","364.0","374654.0",291,144,147,159,99,60,214,111,103,"5","2","1","1","1","5.0","1.0","2.0","1.0","1.0"
"ranchi","jharkhand","Mithudih","364.0","374655.0",718,358,360,407,238,169,424,200,224,"4","1","1","1","1","7.0","1.0","2.0","3.0","1.0"
"ranchi","jharkhand","Majhildih","364.0","374656.0",192,106,86,94,63,31,49,47,2,"5","2","1","1","1","6.0","2.0","2.0","1.0","1.0"
"ranchi","jharkhand","Dimbudih","364.0","374657.0",1087,535,552,618,361,257,626,304,322,"4","1","1","1","1","5.0","1.0","2.0","1.0","1.0"
"ranchi","jharkhand","Baredih","364.0","374658.0",723,355,368,450,273,177,464,232,232,"5","2","1","1","1","6.0","1.0","2.0","2.0","1.0"
"ranchi","jharkhand","Dulmi","364.0","374660.0",1228,624,604,742,449,293,827,415,412,"4","1","1","1","1","6.0","2.0","2.0","1.0","1.0"
"ranchi","jharkhand","Sosodih","364.0","374661.0",448,222,226,159,109,50,238,115,123,"4","1","1","1","1","8.0","2.0","2.0","3.0","1.0"
"ranchi","jharkhand","Sarmali","364.0","374662.0",431,229,202,297,175,122,240,117,123,"4","1","1","1","1","5.0","1.0","2.0","1.0","1.0"
"ranchi","jharkhand","Nowadih","364.0","374663.0",712,357,355,446,263,183,402,196,206,"4","1","1","1","1","5.0","1.0","2.0","1.0","1.0"
"ranchi","jharkhand","Edeldih","364.0","374664.0",462,230,232,309,176,133,294,150,144,"5","1","1","2","1","6.0","2.0","2.0","1.0","1.0"
"ranchi","jharkhand","Peraidih","364.0","374666.0",1563,822,741,948,616,332,773,368,405,"4","1","1","1","1","5.0","1.0","2.0","1.0","1.0"
"ranchi","jharkhand","Rolabera","364.0","374667.0",320,169,151,190,120,70,151,67,84,"4","1","1","1","1","5.0","1.0","2.0","1.0","1.0"
"ranchi","jharkhand","Janumpiri","364.0","374668.0",2317,1165,1152,1316,778,538,1320,661,659,"4","1","1","1","1","6.0","2.0","2.0","1.0","1.0"
"ranchi","jharkhand","Dubla","364.0","374669.0",402,207,195,233,154,79,325,172,153,"4","1","1","1","1","5.0","1.0","2.0","1.0","1.0"
"ranchi","jharkhand","Nuridih","364.0","374670.0",936,479,457,487,325,162,631,317,314,"6","3","1","1","1","5.0","1.0","2.0","1.0","1.0"
"ranchi","jharkhand","Agra","364.0","374671.0",665,325,340,298,188,110,390,188,202,"5","2","1","1","1","6.0","2.0","2.0","1.0","1.0"
"ranchi","jharkhand","Bodhdih","364.0","374672.0",363,182,181,195,125,70,229,124,105,"5","2","1","1","1","6.0","2.0","2.0","1.0","1.0"
"ranchi","jharkhand","Dero","364.0","374673.0",744,366,378,384,242,142,399,195,204,"5","2","1","1","1","5.0","2.0","1.0","1.0","1.0"
"ranchi","jharkhand","Baru","364.0","374674.0",300,147,153,196,112,84,182,91,91,"5","2","1","1","1","7.0","2.0","2.0","2.0","1.0"
"ranchi","jharkhand","Achudih","364.0","374675.0",343,166,177,211,129,82,169,93,76,"4","1","1","1","1","7.0","2.0","2.0","2.0","1.0"
"ranchi","jharkhand","Burudih","364.0","374676.0",433,227,206,304,185,119,141,114,27,"5","2","1","1","1","9.0","2.0","3.0","3.0","1.0"
"ranchi","jharkhand","Amhesa","364.0","374677.0",1629,787,842,993,597,396,822,427,395,"5","2","1","1","1","5.0","1.0","2.0","1.0","1.0"
"ranchi","jharkhand","Babaikundi","364.0","374678.0",772,394,378,408,275,133,229,213,16,"5","2","1","1","1","7.0","2.0","2.0","2.0","1.0"
"ranchi","jharkhand","Diuri","364.0","374679.0",1357,699,658,774,489,285,654,362,292,"5","2","1","1","1","5.0","1.0","2.0","1.0","1.0"
"ranchi","jharkhand","Kokadih","364.0","374680.0",153,80,73,91,61,30,93,51,42,"5","2","1","1","1","6.0","2.0","2.0","1.0","1.0"
"ranchi","jharkhand","Jahartikar","364.0","374681.0",396,199,197,231,143,88,238,123,115,"5","2","1","1","1","6.0","2.0","2.0","1.0","1.0"
"ranchi","jharkhand","Jhargaon","364.0","374682.0",750,364,386,394,235,159,432,218,214,"5","2","1","1","1","7.0","2.0","2.0","2.0","1.0"
"ranchi","jharkhand","Tamar","364.0","374683.0",12345,6312,6033,7286,4404,2882,5599,3272,2327,"4","1","1","1","1","5.0","1.0","2.0","1.0","1.0"
"ranchi","jharkhand","Pundidiri","364.0","374684.0",2042,1054,988,1258,768,490,1013,581,432,"5","2","1","1","1","5.0","1.0","2.0","1.0","1.0"
"ranchi","jharkhand","Jaradih","364.0","374685.0",474,253,221,258,157,101,188,126,62,"4","1","1","1","1","5.0","1.0","2.0","1.0","1.0"
"ranchi","jharkhand","Sarjamdih","364.0","374686.0",238,115,123,128,74,54,131,67,64,"4","1","1","1","1","7.0","1.0","2.0","1.0","3.0"
"ranchi","jharkhand","Murpa","364.0","374688.0",1086,594,492,648,445,203,416,240,176,"5","2","1","1","1","5.0","1.0","2.0","1.0","1.0"
"ranchi","jharkhand","Burudih","364.0","374689.0",749,368,381,440,260,180,435,211,224,"4","1","1","1","1","5.0","1.0","2.0","1.0","1.0"
"ranchi","jharkhand","Poradih","364.0","374690.0",465,240,225,309,179,130,244,123,121,"7","2","3","1","1","5.0","1.0","2.0","1.0","1.0"
"ranchi","jharkhand","Runro","364.0","373549.0",694,349,345,360,203,157,299,162,137,"5","2","1","1","1","5.0","1.0","2.0","1.0","1.0"
"ranchi","jharkhand","Chuttu","364.0","373550.0",3080,1596,1484,1923,1165,758,1370,831,539,"7","1","3","2","1","5.0","1.0","2.0","1.0","1.0"
"ranchi","jharkhand","Kadal","364.0","373551.0",3086,1588,1498,2084,1188,896,1256,809,447,"10","1","3","3","3","5.0","1.0","2.0","1.0","1.0"
"ranchi","jharkhand","Gatlatu","364.0","373552.0",1413,692,721,981,543,438,471,289,182,"10","1","3","3","3","5.0","1.0","2.0","1.0","1.0"
"ranchi","jharkhand","Hombai","364.0","373553.0",1588,790,798,1028,585,443,471,332,139,"8","1","3","3","1","5.0","1.0","2.0","1.0","1.0"
"ranchi","jharkhand","Rodiya","364.0","373554.0",987,492,495,738,390,348,284,203,81,"10","1","3","3","3","4.0","1.0","1.0","1.0","1.0"
"ranchi","jharkhand","Mesra","364.0","373555.0",9476,5453,4023,6722,4352,2370,3114,2195,919,"10","1","3","3","3","5.0","1.0","2.0","1.0","1.0"
"ranchi","jharkhand","Sugnu","364.0","373556.0",3443,1725,1718,1884,1105,779,1060,758,302,"8","1","3","3","1","5.0","1.0","2.0","1.0","1.0"
"ranchi","jharkhand","Lalganj","364.0","373557.0",1931,960,971,1226,696,530,632,430,202,"10","1","3","3","3","9.0","3.0","2.0","3.0","1.0"
"ranchi","jharkhand","Pertol","364.0","373558.0",991,477,514,536,297,239,268,192,76,"6","1","3","1","1","5.0","1.0","2.0","1.0","1.0"
"ranchi","jharkhand","Khatanaga","364.0","373559.0",1630,780,850,863,484,379,665,379,286,"7","1","2","3","1","4.0","1.0","1.0","1.0","1.0"
"ranchi","jharkhand","Dumardaga","364.0","373560.0",7100,3771,3329,5653,3135,2518,1470,1275,195,"10","1","3","3","3","8.0","1.0","3.0","3.0","1.0"
"ranchi","jharkhand","Buti","364.0","373561.0",150,77,73,115,65,50,35,35,0,"12","3","3","3","3","5.0","1.0","2.0","1.0","1.0"
"ranchi","jharkhand","Boreya","364.0","373562.0",4151,2128,2023,2818,1608,1210,1328,929,399,"9","1","3","2","3","6.0","2.0","2.0","1.0","1.0"
"ranchi","jharkhand","Jaipur","364.0","373563.0",2560,1313,1247,1746,950,796,785,525,260,"11","2","3","3","3","5.0","1.0","2.0","1.0","1.0"
"ranchi","jharkhand","Misirgonda Alias Pahargonda ","364.0","373564.0",647,313,334,387,215,172,225,148,77,"8","1","3","3","1","8.0","1.0","3.0","3.0","1.0"
"ranchi","jharkhand","Chandra","364.0","373567.0",2361,1212,1149,1116,675,441,1056,642,414,"4","1","1","1","1","6.0","1.0","3.0","1.0","1.0"
"ranchi","jharkhand","Parsa Toli","364.0","373568.0",173,85,88,83,54,29,127,64,63,"4","1","1","1","1","5.0","1.0","2.0","1.0","1.0"
"ranchi","jharkhand","Sadma","364.0","373569.0",1488,767,721,770,491,279,394,342,52,"4","1","1","1","1","5.0","1.0","2.0","1.0","1.0"
"ranchi","jharkhand","Madkama(Madhukama)","364.0","373570.0",882,459,423,484,296,188,345,224,121,"5","2","1","1","1","5.0","1.0","2.0","1.0","1.0"
"ranchi","jharkhand","Mayapur","364.0","373571.0",1771,911,860,961,580,381,723,443,280,"5","1","2","1","1","4.0","1.0","1.0","1.0","1.0"
"ranchi","jharkhand","Bundu","364.0","373572.0",439,240,199,195,125,70,128,114,14,"5","2","1","1","1","7.0","3.0","2.0","1.0","1.0"
"ranchi","jharkhand","Santi","364.0","373573.0",1046,548,498,534,344,190,448,251,197,"6","2","2","1","1","6.0","1.0","3.0","1.0","1.0"
"ranchi","jharkhand","Hochai","364.0","373574.0",722,378,344,358,224,134,277,186,91,"5","2","1","1","1","5.0","1.0","2.0","1.0","1.0"
"ranchi","jharkhand","Jirabar (Jirawar)","364.0","373575.0",706,346,360,372,208,164,310,179,131,"4","1","1","1","1","5.0","1.0","2.0","1.0","1.0"
"ranchi","jharkhand","Kulhi","364.0","373577.0",2015,1052,963,1115,690,425,706,503,203,"5","1","2","1","1","6.0","1.0","3.0","1.0","1.0"
"ranchi","jharkhand","Kuchu","364.0","373578.0",2371,1229,1142,1502,881,621,1134,670,464,"6","2","2","1","1","5.0","1.0","2.0","1.0","1.0"
"ranchi","jharkhand","Dhakjiban","364.0","373579.0",67,32,35,34,21,13,32,14,18,"5","2","1","1","1","6.0","1.0","3.0","1.0","1.0"
"ranchi","jharkhand","Dundun","364.0","373581.0",601,267,334,286,153,133,248,140,108,"4","1","1","1","1","6.0","1.0","3.0","1.0","1.0"
"ranchi","jharkhand","Tirla","364.0","373582.0",325,156,169,142,82,60,162,81,81,"4","1","1","1","1","6.0","1.0","3.0","1.0","1.0"
"ranchi","jharkhand","Jawabera","364.0","373583.0",531,275,256,248,158,90,385,204,181,"4","1","1","1","1","5.0","1.0","2.0","1.0","1.0"
"ranchi","jharkhand","Gunja","364.0","373584.0",897,468,429,521,317,204,353,229,124,"4","1","1","1","1","6.0","1.0","3.0","1.0","1.0"
"ranchi","jharkhand","Mandro(Mandroh)","364.0","373585.0",1083,546,537,496,294,202,296,243,53,"5","2","1","1","1","5.0","1.0","2.0","1.0","1.0"
"ranchi","jharkhand","Hindebilli","364.0","373586.0",1439,711,728,742,455,287,731,395,336,"6","2","2","1","1","6.0","1.0","3.0","1.0","1.0"
"ranchi","jharkhand","Keram","364.0","373587.0",150,79,71,71,47,24,72,34,38,"4","1","1","1","1","4.0","1.0","1.0","1.0","1.0"
"ranchi","jharkhand","Ara","364.0","373588.0",427,225,202,209,127,82,223,118,105,"5","2","1","1","1","5.0","1.0","2.0","1.0","1.0"
"ranchi","jharkhand","Chapabar(Chapawar)","364.0","373590.0",762,379,383,374,216,158,327,205,122,"4","1","1","1","1","5.0","1.0","2.0","1.0","1.0"
"ranchi","jharkhand","Barwe","364.0","373591.0",2634,1370,1264,1420,847,573,850,652,198,"5","1","2","1","1","6.0","1.0","3.0","1.0","1.0"
"ranchi","jharkhand","Dahu","364.0","373592.0",1760,889,871,1098,630,468,671,433,238,"6","2","2","1","1","7.0","1.0","2.0","1.0","3.0"
"ranchi","jharkhand","Koilari","364.0","373593.0",738,378,360,532,283,249,237,169,68,"8","1","2","2","3","4.0","1.0","1.0","1.0","1.0"
"ranchi","jharkhand","Hutup","364.0","373594.0",1294,654,640,782,459,323,376,297,79,"9","2","3","3","1","5.0","1.0","2.0","1.0","1.0"
"ranchi","jharkhand","Karma","364.0","373595.0",3407,1731,1676,2169,1214,955,888,744,144,"9","1","2","3","3","5.0","1.0","2.0","1.0","1.0"
"ranchi","jharkhand","Rukka","364.0","373596.0",1907,1007,900,1175,722,453,500,424,76,"6","1","3","1","1","12.0","3.0","3.0","3.0","3.0"
"ranchi","jharkhand","Chakla","364.0","373597.0",3450,1820,1630,2176,1313,863,1221,860,361,"9","2","3","3","1","5.0","1.0","2.0","1.0","1.0"
"ranchi","jharkhand","Dardag","364.0","373598.0",1834,945,889,1253,706,547,672,433,239,"11","2","3","3","3","5.0","1.0","2.0","1.0","1.0"
"ranchi","jharkhand","Harchanda","364.0","373599.0",1894,980,914,1351,780,571,648,517,131,"8","2","2","3","1","4.0","1.0","1.0","1.0","1.0"
"ranchi","jharkhand","Sildiri","364.0","373600.0",930,480,450,631,374,257,294,223,71,"6","2","2","1","1","6.0","1.0","3.0","1.0","1.0"
"ranchi","jharkhand","Hesatu","364.0","373601.0",549,298,251,320,199,121,278,152,126,"4","1","1","1","1","6.0","1.0","3.0","1.0","1.0"
"ranchi","jharkhand","Gagari","364.0","373602.0",1143,585,558,558,369,189,494,298,196,"5","2","1","1","1","5.0","1.0","2.0","1.0","1.0"
"ranchi","jharkhand","Chapra Kocha","364.0","373603.0",407,195,212,237,133,104,288,143,145,"5","1","2","1","1","5.0","1.0","2.0","1.0","1.0"
"ranchi","jharkhand","Lupunga","364.0","373604.0",217,103,114,91,48,43,89,49,40,"4","1","1","1","1","6.0","1.0","3.0","1.0","1.0"
"ranchi","jharkhand","Bijang","364.0","373605.0",501,263,238,193,125,68,239,131,108,"5","2","1","1","1","5.0","1.0","2.0","1.0","1.0"
"ranchi","jharkhand","Tunahuli","364.0","373606.0",1066,551,515,641,381,260,471,266,205,"5","2","1","1","1","5.0","1.0","2.0","1.0","1.0"
"ranchi","jharkhand","Halbadi","364.0","373607.0",360,179,181,153,105,48,207,101,106,"5","2","1","1","1","5.0","1.0","2.0","1.0","1.0"
"ranchi","jharkhand","Ichadag","364.0","373608.0",1392,717,675,702,447,255,606,378,228,"4","1","1","1","1","5.0","1.0","2.0","1.0","1.0"
"ranchi","jharkhand","Piska","364.0","373609.0",1149,588,561,556,336,220,482,307,175,"4","1","1","1","1","7.0","3.0","2.0","1.0","1.0"
"ranchi","jharkhand","Pundag","364.0","373610.0",514,245,269,239,136,103,249,130,119,"4","1","1","1","1","9.0","3.0","2.0","3.0","1.0"
"ranchi","jharkhand","Manatu","364.0","373611.0",745,378,367,331,207,124,208,170,38,"5","1","2","1","1","5.0","1.0","2.0","1.0","1.0"
"ranchi","jharkhand","Chultupalu","364.0","373612.0",1980,1002,978,1117,673,444,695,489,206,"5","1","2","1","1","4.0","1.0","1.0","1.0","1.0"
"ranchi","jharkhand","Saher","364.0","373614.0",187,80,107,84,43,41,56,35,21,"6","2","2","1","1","4.0","1.0","1.0","1.0","1.0"
"ranchi","jharkhand","Kurum","364.0","373615.0",1039,542,497,497,311,186,400,283,117,"5","2","1","1","1","5.0","1.0","2.0","1.0","1.0"
"ranchi","jharkhand","Tirla","364.0","373616.0",72,37,35,38,25,13,29,18,11,"5","2","1","1","1","5.0","1.0","2.0","1.0","1.0"
"ranchi","jharkhand","Palu","364.0","373617.0",805,420,385,527,313,214,317,208,109,"6","2","2","1","1","8.0","2.0","2.0","3.0","1.0"
"ranchi","jharkhand","Dunde","364.0","373618.0",375,197,178,171,100,71,135,99,36,"5","1","2","1","1","7.0","3.0","2.0","1.0","1.0"
"ranchi","jharkhand","Jidu","364.0","373619.0",952,476,476,500,291,209,428,267,161,"6","2","2","1","1","7.0","3.0","2.0","1.0","1.0"
"ranchi","jharkhand","Bargainbanda","364.0","373620.0",500,256,244,241,156,85,226,134,92,"5","1","2","1","1","6.0","1.0","3.0","1.0","1.0"
"ranchi","jharkhand","Piparbanda","364.0","373621.0",440,221,219,218,124,94,264,129,135,"4","1","1","1","1","6.0","1.0","3.0","1.0","1.0"
"ranchi","jharkhand","Baghinbanda","364.0","373622.0",175,88,87,55,32,23,113,57,56,"5","2","1","1","1","5.0","1.0","2.0","1.0","1.0"
"ranchi","jharkhand","Tapa","364.0","373623.0",1033,550,483,471,303,168,682,351,331,"5","1","2","1","1","7.0","3.0","2.0","1.0","1.0"
"ranchi","jharkhand","Khatanga","364.0","373624.0",827,415,412,468,284,184,317,206,111,"4","1","1","1","1","5.0","1.0","2.0","1.0","1.0"
"ranchi","jharkhand","Ulatu","364.0","373625.0",682,344,338,388,229,159,346,168,178,"6","2","2","1","1","5.0","1.0","2.0","1.0","1.0"
"ranchi","jharkhand","Ormanjhi","364.0","373626.0",3956,2030,1926,2863,1597,1266,1417,1052,365,"10","1","3","3","3","5.0","1.0","2.0","1.0","1.0"
"ranchi","jharkhand","Anandi","364.0","373627.0",2935,1537,1398,1866,1142,724,876,714,162,"7","1","2","3","1","4.0","1.0","1.0","1.0","1.0"
"ranchi","jharkhand","Ukrid","364.0","373628.0",773,407,366,416,255,161,315,196,119,"6","2","2","1","1","8.0","1.0","3.0","3.0","1.0"
"ranchi","jharkhand","Jhiri","364.0","373629.0",291,163,128,168,103,65,87,69,18,"7","1","2","3","1","5.0","1.0","2.0","1.0","1.0"
"ranchi","jharkhand","Koalu (Qalu)","364.0","373630.0",168,79,89,99,59,40,79,42,37,"6","2","2","1","1","6.0","2.0","2.0","1.0","1.0"
"ranchi","jharkhand","Chetarbari","364.0","373631.0",734,367,367,373,227,146,380,211,169,"6","2","2","1","1","7.0","3.0","2.0","1.0","1.0"
"ranchi","jharkhand","Guru","364.0","373632.0",1186,587,599,591,366,225,574,306,268,"6","2","2","1","1","5.0","1.0","2.0","1.0","1.0"
"ranchi","jharkhand","Rola","364.0","373633.0",244,119,125,103,53,50,190,88,102,"6","2","2","1","1","5.0","1.0","2.0","1.0","1.0"
"ranchi","jharkhand","Gurgain","364.0","373634.0",471,246,225,237,145,92,163,124,39,"4","1","1","1","1","4.0","1.0","1.0","1.0","1.0"
"ranchi","jharkhand","Bartua","364.0","373635.0",697,340,357,380,232,148,184,140,44,"5","2","1","1","1","5.0","1.0","2.0","1.0","1.0"
"ranchi","jharkhand","Jaidiha","364.0","373636.0",1027,513,514,516,313,203,474,280,194,"5","1","2","1","1","5.0","1.0","2.0","1.0","1.0"
"ranchi","jharkhand","Ganeshpur","364.0","373637.0",591,295,296,268,163,105,275,150,125,"4","1","1","1","1","5.0","1.0","2.0","1.0","1.0"
"ranchi","jharkhand","Muta","364.0","373638.0",426,220,206,240,152,88,199,111,88,"5","2","1","1","1","5.0","1.0","2.0","1.0","1.0"
"ranchi","jharkhand","Banlotwa","364.0","373639.0",418,219,199,216,135,81,189,93,96,"5","1","2","1","1","6.0","1.0","3.0","1.0","1.0"
"ranchi","jharkhand","Hindebili","364.0","373640.0",342,190,152,116,76,40,126,102,24,"5","2","1","1","1","5.0","1.0","2.0","1.0","1.0"
"ranchi","jharkhand","Charo","364.0","373641.0",1409,737,672,736,465,271,810,417,393,"6","2","2","1","1","5.0","1.0","2.0","1.0","1.0"
"ranchi","jharkhand","Hethnagru","364.0","373642.0",402,213,189,197,129,68,198,101,97,"5","2","1","1","1","6.0","2.0","2.0","1.0","1.0"
"ranchi","jharkhand","Bhusur","364.0","373644.0",745,376,369,402,244,158,447,226,221,"5","1","2","1","1","5.0","1.0","2.0","1.0","1.0"
"ranchi","jharkhand","Datma(Utma)","364.0","373645.0",761,400,361,391,235,156,409,254,155,"5","2","1","1","1","6.0","1.0","2.0","1.0","2.0"
"ranchi","jharkhand","Sanri","364.0","373647.0",668,353,315,399,259,140,228,185,43,"5","2","1","1","1","5.0","1.0","2.0","1.0","1.0"
"ranchi","jharkhand","Khudiya","364.0","373648.0",519,269,250,302,183,119,190,125,65,"5","2","1","1","1","5.0","1.0","2.0","1.0","1.0"
"ranchi","jharkhand","Lotwa","364.0","373649.0",373,182,191,185,103,82,138,95,43,"6","2","2","1","1","4.0","1.0","1.0","1.0","1.0"
"ranchi","jharkhand","Pancha","364.0","373651.0",1713,889,824,970,576,394,758,485,273,"9","2","3","3","1","6.0","1.0","3.0","1.0","1.0"
"ranchi","jharkhand","Baridihi","364.0","373652.0",3325,1687,1638,1920,1107,813,1258,838,420,"5","1","2","1","1","7.0","3.0","2.0","1.0","1.0"
"ranchi","jharkhand","Sawaiya","364.0","373653.0",185,93,92,88,53,35,121,64,57,"4","1","1","1","1","7.0","3.0","2.0","1.0","1.0"
"ranchi","jharkhand","Hatwal","364.0","373654.0",808,408,400,484,284,200,423,224,199,"6","2","2","1","1","4.0","1.0","1.0","1.0","1.0"
"ranchi","jharkhand","Matatu (Manatu)","364.0","373655.0",462,248,214,269,163,106,254,129,125,"6","2","2","1","1","5.0","1.0","2.0","1.0","1.0"
"ranchi","jharkhand","Id","364.0","373658.0",896,472,424,471,281,190,236,199,37,"4","1","1","1","1","5.0","1.0","2.0","1.0","1.0"
"ranchi","jharkhand","Bakshidih","364.0","373660.0",509,271,238,279,164,115,187,117,70,"5","1","2","1","1","5.0","1.0","2.0","1.0","1.0"
"ranchi","jharkhand","Saheda","364.0","373661.0",534,281,253,209,132,77,241,121,120,"6","2","2","1","1","5.0","1.0","2.0","1.0","1.0"
"ranchi","jharkhand","Jaspur","364.0","373662.0",655,340,315,391,244,147,224,182,42,"7","2","3","1","1","5.0","1.0","2.0","1.0","1.0"
"ranchi","jharkhand","Pailada Or Nagraberadegadegi","364.0","373663.0",687,330,357,370,202,168,344,172,172,"5","2","1","1","1","10.0","3.0","3.0","3.0","1.0"
"ranchi","jharkhand","Agartoli","364.0","373664.0",993,526,467,433,265,168,395,243,152,"4","1","1","1","1","5.0","1.0","2.0","1.0","1.0"
"ranchi","jharkhand","Ladhuptola","364.0","373665.0",106,60,46,43,28,15,45,28,17,"4","1","1","1","1","7.0","3.0","2.0","1.0","1.0"
"ranchi","jharkhand","Getalsud","364.0","373666.0",3263,1674,1589,1957,1155,802,1188,828,360,"6","2","2","1","1","6.0","1.0","3.0","1.0","1.0"
"ranchi","jharkhand","Masniya","364.0","373667.0",1051,538,513,641,401,240,328,274,54,"5","2","1","1","1","4.0","1.0","1.0","1.0","1.0"
"ranchi","jharkhand","Maheshpur","364.0","373668.0",2467,1278,1189,1469,861,608,1092,669,423,"5","2","1","1","1","5.0","1.0","2.0","1.0","1.0"
"ranchi","jharkhand","Sirka","364.0","373669.0",2550,1302,1248,1372,839,533,1541,798,743,"5","1","2","1","1","5.0","1.0","2.0","1.0","1.0"
"ranchi","jharkhand","Simaliya","364.0","373670.0",1155,560,595,611,354,257,425,265,160,"7","1","2","3","1","5.0","1.0","2.0","1.0","1.0"
"ranchi","jharkhand","Lalgarh","364.0","373671.0",527,264,263,286,168,118,276,144,132,"5","1","2","1","1","5.0","1.0","2.0","1.0","1.0"
"ranchi","jharkhand","Salhan","364.0","373672.0",1902,976,926,1101,660,441,794,523,271,"7","1","2","3","1","5.0","1.0","2.0","1.0","1.0"
"ranchi","jharkhand","Turup","364.0","373673.0",1767,887,880,1028,619,409,652,432,220,"6","1","1","3","1","5.0","1.0","2.0","1.0","1.0"
"ranchi","jharkhand","Jamuari","364.0","373674.0",255,124,131,137,77,60,108,56,52,"6","2","2","1","1","5.0","1.0","2.0","1.0","1.0"
"ranchi","jharkhand","Masu","364.0","373675.0",1233,619,614,690,410,280,408,273,135,"8","1","3","3","1","5.0","1.0","2.0","1.0","1.0"
"ranchi","jharkhand","Hesal","364.0","373676.0",5207,2636,2571,3119,1855,1264,1967,1363,604,"5","1","2","1","1","5.0","1.0","2.0","1.0","1.0"
"ranchi","jharkhand","Berwari","364.0","373677.0",2327,1164,1163,1479,840,639,825,597,228,"8","1","3","3","1","5.0","1.0","2.0","1.0","1.0"
"ranchi","jharkhand","Chaldag","364.0","373678.0",3634,1849,1785,2213,1314,899,1463,928,535,"6","2","2","1","1","5.0","1.0","2.0","1.0","1.0"
"ranchi","jharkhand","Janum","364.0","373681.0",944,352,592,660,248,412,455,226,229,"7","2","3","1","1","4.0","1.0","1.0","1.0","1.0"
"ranchi","jharkhand","Narayansoso","364.0","373682.0",1377,713,664,742,453,289,748,382,366,"5","2","1","1","1","5.0","1.0","2.0","1.0","1.0"
"ranchi","jharkhand","Angara","364.0","373683.0",2852,1461,1391,1459,895,564,1124,713,411,"4","1","1","1","1","6.0","1.0","3.0","1.0","1.0"
"ranchi","jharkhand","Lupung","364.0","373685.0",1931,978,953,1052,615,437,964,530,434,"5","1","2","1","1","6.0","1.0","3.0","1.0","1.0"
"ranchi","jharkhand","Baheya","364.0","373686.0",974,500,474,572,334,238,643,320,323,"4","1","1","1","1","5.0","1.0","2.0","1.0","1.0"
"ranchi","jharkhand","Chatra","364.0","373688.0",5088,2602,2486,3317,1970,1347,1694,1247,447,"8","1","3","3","1","6.0","2.0","2.0","1.0","1.0"
"ranchi","jharkhand","Burhibera","364.0","373689.0",601,313,288,262,166,96,363,198,165,"4","1","1","1","1","4.0","1.0","1.0","1.0","1.0"
"ranchi","jharkhand","Banpur","364.0","373690.0",1578,840,738,786,485,301,577,338,239,"4","1","1","1","1","5.0","1.0","2.0","1.0","1.0"
"ranchi","jharkhand","Paika","364.0","373691.0",2012,1037,975,1068,660,408,839,519,320,"4","1","1","1","1","8.0","3.0","3.0","1.0","1.0"
"ranchi","jharkhand","Jarga","364.0","373692.0",1716,878,838,1035,598,437,1093,567,526,"4","1","1","1","1","5.0","1.0","2.0","1.0","1.0"
"ranchi","jharkhand","Merha","364.0","373693.0",423,211,212,319,187,132,313,160,153,"4","1","1","1","1","7.0","3.0","2.0","1.0","1.0"
"ranchi","jharkhand","Hapatbera","364.0","373694.0",596,292,304,313,175,138,317,154,163,"4","1","1","1","1","5.0","1.0","2.0","1.0","1.0"
"ranchi","jharkhand","Heslabera","364.0","373695.0",1430,719,711,989,553,436,971,486,485,"4","1","1","1","1","5.0","1.0","2.0","1.0","1.0"
"ranchi","jharkhand","Rajadera","364.0","373696.0",4077,2019,2058,2227,1323,904,1723,1080,643,"5","1","2","1","1","6.0","3.0","1.0","1.0","1.0"
"ranchi","jharkhand","Dhurleta","364.0","373697.0",189,101,88,95,65,30,96,50,46,"6","1","2","1","2","5.0","1.0","2.0","1.0","1.0"
"ranchi","jharkhand","Bisa","364.0","373698.0",2976,1509,1467,1508,907,601,1347,760,587,"4","1","1","1","1","5.0","1.0","2.0","1.0","1.0"
"ranchi","jharkhand","Resham","364.0","373700.0",282,148,134,189,122,67,118,77,41,"6","2","2","1","1","5.0","1.0","2.0","1.0","1.0"
"ranchi","jharkhand","Benadag","364.0","373701.0",415,201,214,264,139,125,244,119,125,"5","2","1","1","1","5.0","1.0","2.0","1.0","1.0"
"ranchi","jharkhand","Soso","364.0","373702.0",1124,573,551,580,378,202,363,260,103,"5","1","2","1","1","5.0","1.0","2.0","1.0","1.0"
"ranchi","jharkhand","Barkigorang","364.0","373703.0",358,190,168,181,116,65,155,92,63,"4","1","1","1","1","5.0","1.0","2.0","1.0","1.0"
"ranchi","jharkhand","Rangamati","364.0","373704.0",675,348,327,363,228,135,335,183,152,"4","1","1","1","1","5.0","1.0","2.0","1.0","1.0"
"ranchi","jharkhand","Nawagarh","364.0","373706.0",2121,1079,1042,1042,636,406,1173,616,557,"5","2","1","1","1","5.0","1.0","2.0","1.0","1.0"
"ranchi","jharkhand","Badri","364.0","373707.0",1438,738,700,743,470,273,525,364,161,"5","2","1","1","1","5.0","1.0","2.0","1.0","1.0"
"ranchi","jharkhand","Malghonghsa","364.0","373708.0",1814,918,896,784,497,287,1108,562,546,"5","2","1","1","1","8.0","2.0","2.0","3.0","1.0"
"ranchi","jharkhand","Hundru","364.0","373709.0",925,452,473,488,279,209,348,227,121,"5","2","1","1","1","5.0","1.0","2.0","1.0","1.0"
"ranchi","jharkhand","Sursu","364.0","373710.0",2026,891,1135,931,543,388,1238,596,642,"4","1","1","1","1","5.0","1.0","2.0","1.0","1.0"
"ranchi","jharkhand","Tati","364.0","373711.0",4147,2096,2051,1914,1154,760,2299,1167,1132,"4","1","1","1","1","6.0","1.0","3.0","1.0","1.0"
"ranchi","jharkhand","Pahar Singh","364.0","373712.0",970,478,492,457,292,165,496,261,235,"4","1","1","1","1","5.0","1.0","2.0","1.0","1.0"
"ranchi","jharkhand","Barwadag","364.0","373713.0",1129,542,587,553,327,226,339,282,57,"4","1","1","1","1","5.0","1.0","2.0","1.0","1.0"
"ranchi","jharkhand","Sitadih","364.0","373714.0",850,420,430,573,331,242,258,172,86,"4","1","1","1","1","5.0","1.0","2.0","1.0","1.0"
"ranchi","jharkhand","Orwabera","364.0","373715.0",564,288,276,100,75,25,308,149,159,"4","1","1","1","1","6.0","2.0","2.0","1.0","1.0"
"ranchi","jharkhand","Jaradih","364.0","373716.0",955,494,461,429,260,169,506,267,239,"4","1","1","1","1","5.0","1.0","2.0","1.0","1.0"
"ranchi","jharkhand","Gutidih","364.0","373717.0",312,159,153,154,93,61,265,132,133,"4","1","1","1","1","6.0","2.0","2.0","1.0","1.0"
"ranchi","jharkhand","Singari","364.0","373718.0",2025,1004,1021,1037,619,418,658,445,213,"4","1","1","1","1","5.0","1.0","2.0","1.0","1.0"
"ranchi","jharkhand","Kuchu","364.0","373719.0",1428,716,712,734,428,306,912,462,450,"5","2","1","1","1","5.0","1.0","2.0","1.0","1.0"
"ranchi","jharkhand","Dimra","364.0","373720.0",1056,508,548,472,265,207,592,293,299,"5","2","1","1","1","5.0","1.0","2.0","1.0","1.0"
"ranchi","jharkhand","Mungadih","364.0","373721.0",327,163,164,151,88,63,171,78,93,"5","2","1","1","1","6.0","2.0","2.0","1.0","1.0"
"ranchi","jharkhand","Nawadih","364.0","373722.0",272,139,133,157,96,61,164,85,79,"5","1","2","1","1","6.0","2.0","2.0","1.0","1.0"
"ranchi","jharkhand","Musangu","364.0","373724.0",1090,532,558,499,302,197,661,316,345,"4","1","1","1","1","8.0","2.0","2.0","1.0","3.0"
"ranchi","jharkhand","Jonha","364.0","373725.0",1982,938,1044,1164,627,537,1080,574,506,"5","1","2","1","1","5.0","2.0","1.0","1.0","1.0"
"ranchi","jharkhand","Dahua","364.0","373726.0",556,283,273,292,176,116,292,160,132,"5","1","2","1","1","6.0","2.0","2.0","1.0","1.0"
"ranchi","jharkhand","Dokad","364.0","373727.0",369,185,184,197,109,88,162,97,65,"4","1","1","1","1","4.0","1.0","1.0","1.0","1.0"
"ranchi","jharkhand","Kamta","364.0","373728.0",1010,510,500,530,308,222,452,251,201,"4","1","1","1","1","5.0","1.0","2.0","1.0","1.0"
"ranchi","jharkhand","Obar(Ober)","364.0","373729.0",1443,695,748,688,382,306,359,299,60,"4","1","1","1","1","5.0","1.0","2.0","1.0","1.0"
"ranchi","jharkhand","Beti(Benti)","364.0","373730.0",1409,712,697,631,380,251,570,346,224,"5","2","1","1","1","5.0","1.0","2.0","1.0","1.0"
"ranchi","jharkhand","Lepsar","364.0","373731.0",1339,677,662,748,428,320,696,383,313,"4","1","1","1","1","5.0","1.0","2.0","1.0","1.0"
"ranchi","jharkhand","Rupru","364.0","373732.0",914,463,451,491,278,213,449,223,226,"4","1","1","1","1","5.0","1.0","2.0","1.0","1.0"
"ranchi","jharkhand","Jaratoli","364.0","373733.0",377,189,188,216,125,91,124,69,55,"5","1","2","1","1","7.0","3.0","2.0","1.0","1.0"
"ranchi","jharkhand","Jidu","364.0","373734.0",852,428,424,401,272,129,454,249,205,"4","1","1","1","1","6.0","3.0","1.0","1.0","1.0"
"ranchi","jharkhand","Guridih","364.0","373735.0",1755,882,873,967,586,381,873,474,399,"5","1","2","1","1","7.0","3.0","2.0","1.0","1.0"
"ranchi","jharkhand","Kashidih","364.0","373736.0",822,427,395,430,269,161,390,193,197,"4","1","1","1","1","5.0","1.0","2.0","1.0","1.0"
"ranchi","jharkhand","Asri","364.0","373737.0",303,147,156,168,103,65,175,84,91,"4","1","1","1","1","5.0","1.0","2.0","1.0","1.0"
"ranchi","jharkhand","Dumargarhi","364.0","373738.0",829,414,415,493,292,201,448,236,212,"4","1","1","1","1","6.0","3.0","1.0","1.0","1.0"
"ranchi","jharkhand","Koynardih","364.0","373739.0",826,399,427,378,243,135,463,221,242,"4","1","1","1","1","5.0","1.0","2.0","1.0","1.0"
"ranchi","jharkhand","Sarugori","364.0","373740.0",880,454,426,551,333,218,370,246,124,"4","1","1","1","1","4.0","1.0","1.0","1.0","1.0"
"ranchi","jharkhand","Purnadih","364.0","373741.0",464,243,221,273,176,97,253,127,126,"6","2","2","1","1","5.0","1.0","2.0","1.0","1.0"
"ranchi","jharkhand","Kochetola","364.0","373742.0",194,90,104,77,50,27,102,49,53,"4","1","1","1","1","7.0","2.0","2.0","2.0","1.0"
"ranchi","jharkhand","Ramdera","364.0","373743.0",286,150,136,126,91,35,167,79,88,"4","1","1","1","1","5.0","1.0","2.0","1.0","1.0"
"ranchi","jharkhand","Kontatola","364.0","373744.0",1213,624,589,584,382,202,502,315,187,"5","2","1","1","1","5.0","1.0","2.0","1.0","1.0"
"ranchi","jharkhand","Kankata","364.0","373745.0",817,417,400,425,260,165,497,252,245,"4","1","1","1","1","5.0","1.0","2.0","1.0","1.0"
"ranchi","jharkhand","Sataki","364.0","373746.0",2303,1173,1130,1453,868,585,1250,629,621,"4","1","1","1","1","6.0","1.0","3.0","1.0","1.0"
"ranchi","jharkhand","Ambajhariya","364.0","373747.0",1989,1008,981,1081,689,392,1135,557,578,"4","1","1","1","1","5.0","1.0","2.0","1.0","1.0"
"ranchi","jharkhand","Suarmara","364.0","373748.0",785,414,371,397,249,148,351,169,182,"4","1","1","1","1","5.0","1.0","2.0","1.0","1.0"
"ranchi","jharkhand","Kombo","364.0","373749.0",1356,678,678,835,492,343,739,366,373,"4","1","1","1","1","4.0","1.0","1.0","1.0","1.0"
"ranchi","jharkhand","Chirudih","364.0","373750.0",379,184,195,256,145,111,212,101,111,"4","1","1","1","1","5.0","1.0","2.0","1.0","1.0"
"ranchi","jharkhand","Bansiya","364.0","373751.0",1817,926,891,1131,670,461,991,506,485,"5","1","2","1","1","6.0","2.0","2.0","1.0","1.0"
"ranchi","jharkhand","Ladhup","364.0","373753.0",1445,728,717,909,540,369,510,362,148,"4","1","1","1","1","5.0","1.0","2.0","1.0","1.0"
"ranchi","jharkhand","Dhanamunji","364.0","373755.0",776,401,375,459,297,162,392,217,175,"4","1","1","1","1","5.0","1.0","2.0","1.0","1.0"
"ranchi","jharkhand","Basantpur","364.0","373756.0",1716,836,880,1077,629,448,607,405,202,"4","1","1","1","1","5.0","1.0","2.0","1.0","1.0"
"ranchi","jharkhand","Badalu","364.0","373757.0",566,287,279,376,226,150,321,154,167,"5","1","2","1","1","5.0","1.0","2.0","1.0","1.0"
"ranchi","jharkhand","Pogra","364.0","373758.0",843,436,407,605,342,263,428,230,198,"5","1","2","1","1","5.0","1.0","2.0","1.0","1.0"
"ranchi","jharkhand","Rangamati","364.0","373759.0",402,212,190,265,152,113,252,127,125,"4","1","1","1","1","5.0","1.0","2.0","1.0","1.0"
"ranchi","jharkhand","Panchu","364.0","373760.0",1027,518,509,681,400,281,552,289,263,"6","1","1","3","1","5.0","1.0","2.0","1.0","1.0"
"ranchi","jharkhand","Nichintpur","364.0","373761.0",329,175,154,137,88,49,188,92,96,"4","1","1","1","1","5.0","1.0","2.0","1.0","1.0"
"ranchi","jharkhand","Maheshpur","364.0","373762.0",736,376,360,448,267,181,466,234,232,"5","1","2","1","1","5.0","1.0","2.0","1.0","1.0"
"ranchi","jharkhand","Domandih","364.0","373763.0",1084,514,570,683,385,298,432,278,154,"4","1","1","1","1","5.0","1.0","2.0","1.0","1.0"
"ranchi","jharkhand","Purnanagar","364.0","373764.0",1206,606,600,705,430,275,626,333,293,"4","1","1","1","1","4.0","1.0","1.0","1.0","1.0"
"ranchi","jharkhand","Ichahatu","364.0","373765.0",572,281,291,382,225,157,373,194,179,"4","1","1","1","1","5.0","1.0","2.0","1.0","1.0"
"ranchi","jharkhand","Guchidih","364.0","373766.0",782,391,391,422,253,169,309,204,105,"4","1","1","1","1","4.0","1.0","1.0","1.0","1.0"
"ranchi","jharkhand","Torang","364.0","373767.0",379,172,207,210,121,89,205,99,106,"4","1","1","1","1","5.0","1.0","2.0","1.0","1.0"
"ranchi","jharkhand","Loahatu","364.0","373768.0",1872,946,926,1146,702,444,1000,509,491,"5","1","2","1","1","6.0","2.0","2.0","1.0","1.0"
"ranchi","jharkhand","Dulmi","364.0","373769.0",1043,555,488,686,428,258,462,295,167,"5","1","2","1","1","5.0","1.0","2.0","1.0","1.0"
"ranchi","jharkhand","Paramdih","364.0","373770.0",966,509,457,602,371,231,567,290,277,"4","1","1","1","1","5.0","1.0","2.0","1.0","1.0"
"ranchi","jharkhand","Basahatu","364.0","373771.0",1011,523,488,663,398,265,598,287,311,"5","1","2","1","1","5.0","1.0","2.0","1.0","1.0"
"ranchi","jharkhand","Nawadih","364.0","373772.0",1217,627,590,780,485,295,776,385,391,"4","1","1","1","1","5.0","1.0","2.0","1.0","1.0"
"ranchi","jharkhand","Burudih","364.0","373773.0",701,352,349,441,270,171,400,187,213,"4","1","1","1","1","5.0","1.0","2.0","1.0","1.0"
"ranchi","jharkhand","Thungrudih","364.0","373774.0",670,321,349,379,220,159,280,172,108,"5","1","2","1","1","5.0","1.0","2.0","1.0","1.0"
"ranchi","jharkhand","Kotangdag","364.0","373775.0",576,279,297,326,188,138,284,151,133,"5","1","2","1","1","6.0","2.0","2.0","1.0","1.0"
"ranchi","jharkhand","Chainpur","364.0","373776.0",1014,530,484,647,394,253,555,276,279,"5","1","2","1","1","5.0","1.0","2.0","1.0","1.0"
"ranchi","jharkhand","Burhadih","364.0","373777.0",62,30,32,30,16,14,37,19,18,"5","2","1","1","1","6.0","2.0","2.0","1.0","1.0"
"ranchi","jharkhand","Dakad","364.0","373778.0",1978,991,987,1215,747,468,1279,640,639,"4","1","1","1","1","5.0","1.0","2.0","1.0","1.0"
"ranchi","jharkhand","Bela","364.0","373779.0",1120,565,555,734,428,306,691,351,340,"5","1","2","1","1","5.0","1.0","2.0","1.0","1.0"
"ranchi","jharkhand","Gomda","364.0","373780.0",1435,693,742,703,419,284,735,358,377,"5","1","2","1","1","5.0","1.0","2.0","1.0","1.0"
"ranchi","jharkhand","Rahe","364.0","373781.0",2949,1547,1402,1958,1141,817,1014,752,262,"6","2","2","1","1","5.0","1.0","2.0","1.0","1.0"
"ranchi","jharkhand","Khatanga","364.0","373782.0",514,251,263,287,178,109,230,106,124,"5","1","2","1","1","5.0","1.0","2.0","1.0","1.0"
"ranchi","jharkhand","Kolma","364.0","373783.0",1596,762,834,903,541,362,789,416,373,"4","1","1","1","1","7.0","1.0","2.0","1.0","3.0"
"ranchi","jharkhand","Nuru","364.0","373784.0",254,128,126,123,79,44,120,65,55,"4","1","1","1","1","5.0","1.0","2.0","1.0","1.0"
"ranchi","jharkhand","Nawadih","364.0","373785.0",638,336,302,291,195,96,323,159,164,"4","1","1","1","1","5.0","1.0","2.0","1.0","1.0"
"ranchi","jharkhand","Goali","364.0","373786.0",523,266,257,318,192,126,312,152,160,"4","1","1","1","1","5.0","1.0","2.0","1.0","1.0"
"ranchi","jharkhand","Barwadih","364.0","373787.0",689,340,349,405,251,154,182,159,23,"4","1","1","1","1","5.0","1.0","2.0","1.0","1.0"
"ranchi","jharkhand","Chirudih","364.0","373788.0",323,161,162,181,108,73,175,89,86,"5","2","1","1","1","5.0","1.0","2.0","1.0","1.0"
"ranchi","jharkhand","Uraondih","364.0","373789.0",610,308,302,427,250,177,415,219,196,"4","1","1","1","1","5.0","1.0","2.0","1.0","1.0"
"ranchi","jharkhand","Kubadih","364.0","373790.0",573,294,279,328,198,130,304,154,150,"4","1","1","1","1","5.0","1.0","2.0","1.0","1.0"
"ranchi","jharkhand","Kateadih","364.0","373791.0",744,386,358,400,249,151,450,226,224,"4","1","1","1","1","5.0","1.0","2.0","1.0","1.0"
"ranchi","jharkhand","Hatlo","364.0","373792.0",1944,1020,924,1186,755,431,578,516,62,"4","1","1","1","1","5.0","1.0","2.0","1.0","1.0"
"ranchi","jharkhand","Phulwar Baherabera","364.0","373793.0",951,472,479,456,286,170,242,229,13,"4","1","1","1","1","5.0","1.0","2.0","1.0","1.0"
"ranchi","jharkhand","Eresereng","364.0","373794.0",710,379,331,402,268,134,408,217,191,"4","1","1","1","1","5.0","1.0","2.0","1.0","1.0"
"ranchi","jharkhand","Siridih","364.0","373795.0",879,450,429,459,300,159,402,245,157,"5","2","1","1","1","6.0","1.0","3.0","1.0","1.0"
"ranchi","jharkhand","Serengdih","364.0","373796.0",430,218,212,226,141,85,270,137,133,"4","1","1","1","1","6.0","3.0","1.0","1.0","1.0"
"ranchi","jharkhand","Ghaghradih","364.0","373797.0",259,126,133,123,77,46,155,74,81,"4","1","1","1","1","5.0","1.0","2.0","1.0","1.0"
"ranchi","jharkhand","Kokrodih","364.0","373798.0",470,226,244,227,132,95,235,115,120,"4","1","1","1","1","6.0","2.0","2.0","1.0","1.0"
"ranchi","jharkhand","Bundiaru","364.0","373799.0",967,506,461,541,351,190,542,277,265,"4","1","1","1","1","4.0","1.0","1.0","1.0","1.0"
"ranchi","jharkhand","Saheda","364.0","373800.0",1123,574,549,704,415,289,625,322,303,"5","1","2","1","1","6.0","1.0","3.0","1.0","1.0"
"ranchi","jharkhand","Halmad","364.0","373801.0",2396,1224,1172,1400,837,563,1343,727,616,"4","1","1","1","1","5.0","1.0","2.0","1.0","1.0"
"ranchi","jharkhand","Bhuli","364.0","373802.0",367,180,187,172,103,69,144,110,34,"4","1","1","1","1","6.0","1.0","3.0","1.0","1.0"
"ranchi","jharkhand","Hakedag","364.0","373803.0",1441,727,714,794,484,310,761,403,358,"4","1","1","1","1","5.0","1.0","2.0","1.0","1.0"
"ranchi","jharkhand","Gajha","364.0","373804.0",340,162,178,224,119,105,252,125,127,"4","1","1","1","1","6.0","2.0","2.0","1.0","1.0"
"ranchi","jharkhand","Misirhutang","364.0","373805.0",631,308,323,300,176,124,221,183,38,"5","2","1","1","1","5.0","1.0","2.0","1.0","1.0"
"ranchi","jharkhand","Jaluhutang","364.0","373806.0",706,345,361,351,223,128,374,190,184,"4","1","1","1","1","6.0","1.0","3.0","1.0","1.0"
"ranchi","jharkhand","Jumla","364.0","373807.0",546,271,275,286,163,123,274,148,126,"4","1","1","1","1","6.0","1.0","3.0","1.0","1.0"
"ranchi","jharkhand","Ajaigarh","364.0","373808.0",1204,614,590,748,433,315,648,338,310,"4","1","1","1","1","5.0","1.0","2.0","1.0","1.0"
"ranchi","jharkhand","Burhabahera","364.0","373809.0",1304,670,634,776,472,304,764,397,367,"4","1","1","1","1","5.0","1.0","2.0","1.0","1.0"
"ranchi","jharkhand","Haridih","364.0","373810.0",991,487,504,528,318,210,598,298,300,"4","1","1","1","1","5.0","1.0","2.0","1.0","1.0"
"ranchi","jharkhand","Gerebir","364.0","373811.0",700,365,335,411,264,147,204,196,8,"7","2","1","1","3","5.0","1.0","2.0","1.0","1.0"
"ranchi","jharkhand","Banuadih","364.0","373812.0",749,397,352,452,287,165,385,202,183,"4","1","1","1","1","5.0","1.0","2.0","1.0","1.0"
"ranchi","jharkhand","Pipardag","364.0","373813.0",485,239,246,291,181,110,163,118,45,"6","1","2","1","2","5.0","1.0","2.0","1.0","1.0"
"ranchi","jharkhand","Tetibauda","364.0","373814.0",1046,529,517,593,353,240,502,312,190,"4","1","1","1","1","6.0","2.0","2.0","1.0","1.0"
"ranchi","jharkhand","Jaradih","364.0","373815.0",167,82,85,99,51,48,53,48,5,"4","1","1","1","1","5.0","1.0","2.0","1.0","1.0"
"ranchi","jharkhand","Rampur","364.0","373817.0",834,412,422,474,292,182,361,223,138,"5","1","2","1","1","6.0","2.0","2.0","1.0","1.0"
"ranchi","jharkhand","Losera","364.0","373818.0",1059,534,525,606,369,237,478,294,184,"4","1","1","1","1","6.0","2.0","2.0","1.0","1.0"
"ranchi","jharkhand","Ludmu","364.0","373819.0",625,316,309,371,224,147,301,173,128,"5","1","2","1","1","6.0","2.0","2.0","1.0","1.0"
"ranchi","jharkhand","Kushumtikra","364.0","373820.0",590,290,300,323,195,128,294,152,142,"4","1","1","1","1","5.0","2.0","1.0","1.0","1.0"
"ranchi","jharkhand","Kutru","364.0","373821.0",907,435,472,543,316,227,424,215,209,"4","1","1","1","1","6.0","2.0","2.0","1.0","1.0"
"ranchi","jharkhand","Bansarori","364.0","373825.0",1875,957,918,1215,708,507,1003,511,492,"5","1","2","1","1","5.0","1.0","2.0","1.0","1.0"
"ranchi","jharkhand","Gargaon","364.0","373826.0",287,151,136,182,108,74,123,76,47,"5","1","2","1","1","7.0","2.0","2.0","2.0","1.0"
"ranchi","jharkhand","Piska","364.0","373827.0",1132,575,557,703,423,280,558,290,268,"5","1","2","1","1","6.0","2.0","2.0","1.0","1.0"
"ranchi","jharkhand","Madni","364.0","373828.0",742,364,378,447,259,188,374,182,192,"4","1","1","1","1","4.0","1.0","1.0","1.0","1.0"
"ranchi","jharkhand","Nagedih","364.0","373829.0",1258,628,630,804,481,323,712,364,348,"4","1","1","1","1","6.0","2.0","2.0","1.0","1.0"
"ranchi","jharkhand","Khalari","364.0","373830.0",494,256,238,339,197,142,400,201,199,"4","1","1","1","1","6.0","2.0","2.0","1.0","1.0"
"ranchi","jharkhand","Goradih","364.0","373831.0",2754,1400,1354,1586,946,640,1765,923,842,"4","1","1","1","1","6.0","2.0","2.0","1.0","1.0"
"ranchi","jharkhand","Bamhni(Bhabhani)","364.0","373832.0",1792,903,889,1135,668,467,934,475,459,"4","1","1","1","1","5.0","1.0","2.0","1.0","1.0"
"ranchi","jharkhand","Holong","364.0","373833.0",53,25,28,20,11,9,28,14,14,"4","1","1","1","1","5.0","1.0","2.0","1.0","1.0"
"ranchi","jharkhand","Nawadih","364.0","373834.0",331,162,169,193,117,76,190,87,103,"5","1","2","1","1","6.0","2.0","2.0","1.0","1.0"
"ranchi","jharkhand","Hesadih","364.0","373835.0",352,176,176,180,114,66,241,118,123,"5","2","1","1","1","6.0","2.0","2.0","1.0","1.0"
"ranchi","jharkhand","Kulsud","364.0","373836.0",805,422,383,496,304,192,459,231,228,"5","1","2","1","1","6.0","2.0","2.0","1.0","1.0"
"ranchi","jharkhand","Meral","364.0","374128.0",498,252,246,339,191,148,191,119,72,"9","2","2","2","3","5.0","1.0","2.0","1.0","1.0"
"ranchi","jharkhand","Kota","364.0","374129.0",1244,629,615,711,417,294,711,400,311,"6","2","2","1","1","5.0","1.0","2.0","1.0","1.0"
"ranchi","jharkhand","Jaipur","364.0","374130.0",1008,504,504,545,303,242,212,144,68,"8","1","3","3","1","5.0","1.0","2.0","1.0","1.0"
"ranchi","jharkhand","Saparom","364.0","374131.0",3073,1535,1538,1990,1110,880,1220,727,493,"5","1","2","1","1","5.0","1.0","2.0","1.0","1.0"
"ranchi","jharkhand","Gutuwa","364.0","374132.0",4835,2477,2358,3061,1747,1314,1485,1126,359,"7","2","3","1","1","4.0","1.0","1.0","1.0","1.0"
"ranchi","jharkhand","Pundag","364.0","374133.0",2285,1183,1102,1511,907,604,835,594,241,"11","2","3","3","3","5.0","1.0","2.0","1.0","1.0"
"ranchi","jharkhand","Hotwasi","364.0","374134.0",1587,767,820,991,557,434,571,383,188,"7","2","3","1","1","6.0","1.0","3.0","1.0","1.0"
"ranchi","jharkhand","Harser","364.0","374136.0",1169,585,584,875,491,384,411,290,121,"10","1","3","3","3","6.0","1.0","1.0","1.0","3.0"
"ranchi","jharkhand","Balalong","364.0","374137.0",2261,1140,1121,1481,837,644,802,590,212,"8","1","3","3","1","5.0","1.0","2.0","1.0","1.0"
"ranchi","jharkhand","Baridih","364.0","374138.0",577,288,289,328,175,153,330,164,166,"5","2","1","1","1","5.0","1.0","2.0","1.0","1.0"
"ranchi","jharkhand","Singhpur","364.0","374139.0",1206,594,612,557,317,240,377,246,131,"4","1","1","1","1","5.0","1.0","2.0","1.0","1.0"
"ranchi","jharkhand","Sembo","364.0","374140.0",1405,764,641,733,485,248,664,424,240,"5","1","2","1","1","5.0","1.0","2.0","1.0","1.0"
"ranchi","jharkhand","Bandratoli","364.0","374141.0",358,175,183,226,127,99,160,95,65,"6","2","2","1","1","6.0","2.0","2.0","1.0","1.0"
"ranchi","jharkhand","Chete","364.0","374143.0",2151,1060,1091,1212,689,523,756,512,244,"5","1","2","1","1","5.0","1.0","2.0","1.0","1.0"
"ranchi","jharkhand","Hatma","364.0","374145.0",1239,603,636,575,327,248,470,318,152,"4","1","1","1","1","6.0","1.0","3.0","1.0","1.0"
"ranchi","jharkhand","Rege","364.0","374146.0",624,315,309,296,166,130,263,135,128,"6","2","2","1","1","7.0","3.0","2.0","1.0","1.0"
"ranchi","jharkhand","Karge","364.0","374147.0",4665,2375,2290,2833,1615,1218,1738,1098,640,"6","2","2","1","1","5.0","1.0","2.0","1.0","1.0"
"ranchi","jharkhand","Tigoiambatoli","364.0","374148.0",2471,1270,1201,1329,800,529,1139,640,499,"4","1","1","1","1","6.0","1.0","3.0","1.0","1.0"
"ranchi","jharkhand","Hesal","364.0","374149.0",1146,562,584,519,280,239,360,234,126,"5","2","1","1","1","5.0","1.0","2.0","1.0","1.0"
"ranchi","jharkhand","Garmi","364.0","374150.0",492,258,234,306,177,129,222,113,109,"4","1","1","1","1","8.0","1.0","3.0","3.0","1.0"
"ranchi","jharkhand","Chigri","364.0","374151.0",648,315,333,436,243,193,392,198,194,"6","1","2","2","1","5.0","1.0","2.0","1.0","1.0"
"ranchi","jharkhand","Deuri Alias Dongatoli","364.0","374152.0",548,272,276,340,183,157,272,156,116,"5","1","2","1","1","5.0","1.0","2.0","1.0","1.0"
"ranchi","jharkhand","Bajra","364.0","374153.0",1337,662,675,669,395,274,819,396,423,"8","2","2","3","1","5.0","1.0","2.0","1.0","1.0"
"ranchi","jharkhand","Babro","364.0","374154.0",1111,558,553,668,390,278,681,339,342,"7","2","1","3","1","5.0","1.0","2.0","1.0","1.0"
"ranchi","jharkhand","Dumri","364.0","374155.0",1501,793,708,576,345,231,618,377,241,"8","1","2","3","2","4.0","1.0","1.0","1.0","1.0"
"ranchi","jharkhand","Charki","364.0","374156.0",586,293,293,281,167,114,356,185,171,"7","3","1","2","1","5.0","1.0","2.0","1.0","1.0"
"ranchi","jharkhand","Mandro","364.0","374157.0",1626,862,764,940,572,368,730,426,304,"8","2","2","3","1","4.0","1.0","1.0","1.0","1.0"
"ranchi","jharkhand","Charnalo","364.0","374158.0",262,132,130,111,77,34,121,62,59,"4","1","1","1","1","5.0","1.0","2.0","1.0","1.0"
"ranchi","jharkhand","Jhikpur","364.0","374159.0",732,382,350,411,250,161,414,220,194,"10","2","2","3","3","5.0","1.0","2.0","1.0","1.0"
"ranchi","jharkhand","Sarwa","364.0","374160.0",2939,1463,1476,1397,804,593,1994,1005,989,"6","1","1","3","1","5.0","1.0","2.0","1.0","1.0"
"ranchi","jharkhand","Kurkura","364.0","374161.0",1479,751,728,831,494,337,721,411,310,"8","2","2","3","1","5.0","1.0","2.0","1.0","1.0"
"ranchi","jharkhand","Bakhar","364.0","374162.0",519,262,257,192,121,71,285,144,141,"7","2","2","2","1","5.0","1.0","2.0","1.0","1.0"
"ranchi","jharkhand","Kaimbo","364.0","374163.0",2505,1273,1232,1235,719,516,1218,634,584,"6","1","2","2","1","6.0","1.0","3.0","1.0","1.0"
"ranchi","jharkhand","Hesmi","364.0","374164.0",2431,1191,1240,1767,903,864,871,535,336,"11","2","3","3","3","5.0","1.0","2.0","1.0","1.0"
"ranchi","jharkhand","Sosai","364.0","374165.0",2435,1221,1214,1726,916,810,1031,601,430,"7","1","2","1","3","5.0","1.0","2.0","1.0","1.0"
"ranchi","jharkhand","Mandar","364.0","374167.0",4027,2031,1996,2699,1458,1241,1213,864,349,"9","1","2","3","3","5.0","1.0","2.0","1.0","1.0"
"ranchi","jharkhand","Malti","364.0","374168.0",2822,1467,1355,1721,1005,716,1172,700,472,"8","2","2","3","1","5.0","1.0","2.0","1.0","1.0"
"ranchi","jharkhand","Chatwal","364.0","374169.0",2163,1115,1048,950,558,392,1105,577,528,"7","2","1","3","1","6.0","1.0","3.0","1.0","1.0"
"ranchi","jharkhand","Keskani","364.0","374170.0",251,128,123,150,91,59,129,71,58,"8","3","3","1","1","5.0","1.0","2.0","1.0","1.0"
"ranchi","jharkhand","Bargari","364.0","374171.0",2400,1243,1157,1301,763,538,1121,667,454,"4","1","1","1","1","5.0","1.0","2.0","1.0","1.0"
"ranchi","jharkhand","Jaher","364.0","374172.0",1935,1001,934,1054,601,453,819,481,338,"4","1","1","1","1","5.0","1.0","2.0","1.0","1.0"
"ranchi","jharkhand","Chund","364.0","374174.0",1742,888,854,874,530,344,1056,546,510,"8","2","2","3","1","5.0","1.0","2.0","1.0","1.0"
"ranchi","jharkhand","Tikotoli","364.0","374175.0",951,472,479,490,280,210,363,214,149,"8","2","2","3","1","6.0","1.0","3.0","1.0","1.0"
"ranchi","jharkhand","Maltoli","364.0","374176.0",607,310,297,338,197,141,320,177,143,"7","2","2","2","1","5.0","1.0","2.0","1.0","1.0"
"ranchi","jharkhand","Mesal","364.0","374178.0",958,489,469,557,322,235,275,223,52,"6","2","2","1","1","5.0","1.0","2.0","1.0","1.0"
"ranchi","jharkhand","Sursa","364.0","374179.0",2749,1387,1362,1521,842,679,1022,671,351,"8","2","2","3","1","5.0","1.0","2.0","1.0","1.0"
"ranchi","jharkhand","Murma","364.0","374180.0",2670,1364,1306,1605,904,701,968,707,261,"6","2","2","1","1","5.0","1.0","2.0","1.0","1.0"
"ranchi","jharkhand","Kandri","364.0","374181.0",819,414,405,557,308,249,239,165,74,"7","1","2","3","1","5.0","1.0","2.0","1.0","1.0"
"ranchi","jharkhand","Karkaria","364.0","374182.0",1912,987,925,1086,640,446,947,493,454,"9","3","2","1","3","5.0","1.0","2.0","1.0","1.0"
"ranchi","jharkhand","Pungi","364.0","374183.0",2151,1050,1101,1242,679,563,988,563,425,"6","2","2","1","1","5.0","1.0","2.0","1.0","1.0"
"ranchi","jharkhand","Kanjiya","364.0","374184.0",3470,1740,1730,2128,1204,924,1521,923,598,"6","1","1","3","1","5.0","1.0","2.0","1.0","1.0"
"ranchi","jharkhand","Banjhila","364.0","374186.0",2856,1418,1438,1412,814,598,1267,662,605,"6","2","2","1","1","4.0","1.0","1.0","1.0","1.0"
"ranchi","jharkhand","Murjuli","364.0","374187.0",1371,682,689,790,453,337,698,353,345,"6","1","1","3","1","5.0","1.0","2.0","1.0","1.0"
"ranchi","jharkhand","Sargaon","364.0","374188.0",1133,561,572,563,322,241,459,223,236,"7","1","2","3","1","5.0","1.0","2.0","1.0","1.0"
"ranchi","jharkhand","Gurgurjari","364.0","374189.0",2461,1253,1208,1363,815,548,1409,746,663,"7","2","1","3","1","6.0","1.0","3.0","1.0","1.0"
"ranchi","jharkhand","Bansjari","364.0","374190.0",1524,743,781,833,459,374,880,449,431,"5","1","1","2","1","5.0","1.0","2.0","1.0","1.0"
"ranchi","jharkhand","Mahuajari","364.0","374191.0",1460,759,701,881,519,362,957,493,464,"9","3","2","3","1","5.0","1.0","2.0","1.0","1.0"
"ranchi","jharkhand","Darjijari","364.0","374192.0",1294,637,657,689,382,307,600,341,259,"6","2","1","2","1","5.0","1.0","2.0","1.0","1.0"
"ranchi","jharkhand","Bishakhatanga","364.0","374194.0",3293,1615,1678,1912,1063,849,1316,732,584,"8","2","2","3","1","5.0","1.0","2.0","1.0","1.0"
"ranchi","jharkhand","Haril","364.0","374195.0",1729,855,874,919,523,396,373,268,105,"8","2","2","3","1","5.0","1.0","2.0","1.0","1.0"
"ranchi","jharkhand","Gorkho","364.0","374196.0",627,317,310,356,195,161,305,160,145,"6","1","2","2","1","5.0","1.0","2.0","1.0","1.0"
"ranchi","jharkhand","Murkuni","364.0","374197.0",838,440,398,393,236,157,282,181,101,"6","2","1","2","1","5.0","1.0","2.0","1.0","1.0"
"ranchi","jharkhand","Kanijari","364.0","374199.0",1089,518,571,697,368,329,685,340,345,"6","2","2","1","1","6.0","1.0","3.0","1.0","1.0"
"ranchi","jharkhand","Pareyago","364.0","374200.0",2579,1361,1218,1251,760,491,1270,716,554,"7","1","2","3","1","5.0","1.0","2.0","1.0","1.0"
"ranchi","jharkhand","Sakra","364.0","374201.0",2885,1460,1425,1614,965,649,1651,875,776,"10","2","2","3","3","4.0","1.0","1.0","1.0","1.0"
"ranchi","jharkhand","Loiyo","364.0","374202.0",3919,1980,1939,2275,1275,1000,1751,1003,748,"7","1","2","3","1","5.0","1.0","2.0","1.0","1.0"
"ranchi","jharkhand","Tangarbasuli","364.0","374203.0",3417,1759,1658,1842,1065,777,1432,911,521,"7","1","2","3","1","5.0","1.0","2.0","1.0","1.0"
"ranchi","jharkhand","Naro","364.0","374204.0",2027,1016,1011,1142,662,480,1071,545,526,"7","2","1","3","1","6.0","1.0","3.0","1.0","1.0"
"ranchi","jharkhand","Gore","364.0","374205.0",1376,701,675,815,483,332,416,338,78,"7","1","3","1","2","6.0","1.0","3.0","1.0","1.0"
"ranchi","jharkhand","Nagra","364.0","374206.0",5929,2945,2984,3464,1933,1531,2562,1499,1063,"7","2","2","2","1","5.0","1.0","2.0","1.0","1.0"
"ranchi","jharkhand","Masmano","364.0","374207.0",1373,709,664,818,468,350,655,352,303,"8","2","2","3","1","6.0","2.0","2.0","1.0","1.0"
"ranchi","jharkhand","Baski","364.0","374208.0",1730,915,815,1008,575,433,1029,547,482,"5","1","2","1","1","5.0","1.0","2.0","1.0","1.0"
"ranchi","jharkhand","Totambi","364.0","374209.0",1086,573,513,716,424,292,491,288,203,"9","2","2","2","3","6.0","2.0","2.0","1.0","1.0"
"ranchi","jharkhand","Jhinghri","364.0","374210.0",2497,1259,1238,1392,802,590,1565,751,814,"8","1","2","3","2","5.0","1.0","2.0","1.0","1.0"
"ranchi","jharkhand","Tatkundo","364.0","374211.0",2288,1164,1124,1356,786,570,1217,618,599,"8","1","2","3","2","5.0","1.0","2.0","1.0","1.0"
"ranchi","jharkhand","Korambe","364.0","374212.0",1359,701,658,684,391,293,855,443,412,"5","1","1","2","1","8.0","1.0","3.0","3.0","1.0"
"ranchi","jharkhand","Sakarpada","364.0","374213.0",1381,701,680,859,504,355,819,423,396,"6","1","2","2","1","5.0","1.0","2.0","1.0","1.0"
"ranchi","jharkhand","Lurangi","364.0","374214.0",338,182,156,218,138,80,172,89,83,"6","2","2","1","1","6.0","2.0","2.0","1.0","1.0"
"ranchi","jharkhand","Honhe","364.0","374215.0",954,478,476,577,335,242,469,257,212,"5","2","1","1","1","7.0","3.0","2.0","1.0","1.0"
"ranchi","jharkhand","Pondri","364.0","374216.0",3519,1809,1710,2025,1096,929,1105,781,324,"5","2","1","1","1","5.0","1.0","2.0","1.0","1.0"
"ranchi","jharkhand","Sonrkhap","364.0","374217.0",73,38,35,50,29,21,43,24,19,"6","2","2","1","1","5.0","1.0","2.0","1.0","1.0"
"ranchi","jharkhand","Balsokra","364.0","374218.0",5518,2848,2670,3581,2024,1557,2054,1326,728,"7","1","2","1","3","5.0","1.0","2.0","1.0","1.0"
"ranchi","jharkhand","Birra","364.0","374219.0",846,418,428,477,264,213,300,173,127,"5","2","1","1","1","5.0","1.0","2.0","1.0","1.0"
"ranchi","jharkhand","Patuk","364.0","374221.0",810,395,415,483,258,225,459,232,227,"6","2","2","1","1","6.0","1.0","3.0","1.0","1.0"
"ranchi","jharkhand","Sons","364.0","374222.0",2664,1246,1418,1604,771,833,1264,693,571,"8","2","2","1","3","6.0","1.0","3.0","1.0","1.0"
"ranchi","jharkhand","Chanho","364.0","374223.0",1626,802,824,923,510,413,775,402,373,"6","2","2","1","1","5.0","1.0","2.0","1.0","1.0"
"ranchi","jharkhand","Buchaopa","364.0","374224.0",261,130,131,135,86,49,115,55,60,"8","2","2","3","1","4.0","1.0","1.0","1.0","1.0"
"ranchi","jharkhand","Lupunga","364.0","374225.0",572,285,287,325,192,133,239,113,126,"6","1","1","3","1","5.0","1.0","2.0","1.0","1.0"
"ranchi","jharkhand","Ganeshpur","364.0","374226.0",2318,1144,1174,1226,694,532,1301,643,658,"6","2","2","1","1","5.0","1.0","2.0","1.0","1.0"
"ranchi","jharkhand","Jaipur","364.0","374227.0",496,252,244,320,187,133,267,131,136,"5","1","2","1","1","5.0","1.0","2.0","1.0","1.0"
"ranchi","jharkhand","Raghunathpur","364.0","374228.0",2767,1427,1340,1506,883,623,1300,661,639,"5","1","2","1","1","4.0","1.0","1.0","1.0","1.0"
"ranchi","jharkhand","Opa","364.0","374229.0",983,526,457,630,358,272,265,193,72,"6","1","3","1","1","5.0","1.0","2.0","1.0","1.0"
"ranchi","jharkhand","Betlangi","364.0","374230.0",1419,706,713,829,479,350,781,459,322,"5","1","2","1","1","5.0","1.0","2.0","1.0","1.0"
"ranchi","jharkhand","Ara","364.0","374231.0",510,266,244,301,176,125,268,133,135,"5","2","1","1","1","5.0","1.0","2.0","1.0","1.0"
"ranchi","jharkhand","Chamranga","364.0","374232.0",693,331,362,365,200,165,166,133,33,"4","1","1","1","1","6.0","1.0","3.0","1.0","1.0"
"ranchi","jharkhand","Ramdaga","364.0","374233.0",951,476,475,471,273,198,349,226,123,"5","1","2","1","1","5.0","1.0","2.0","1.0","1.0"
"ranchi","jharkhand","Chora","364.0","374235.0",2052,1035,1017,960,573,387,825,491,334,"5","2","1","1","1","5.0","1.0","2.0","1.0","1.0"
"ranchi","jharkhand","Bachhau","364.0","374236.0",855,427,428,523,302,221,334,206,128,"12","3","3","3","3","5.0","1.0","2.0","1.0","1.0"
"ranchi","jharkhand","Badri","364.0","374237.0",525,239,286,295,153,142,266,128,138,"4","1","1","1","1","5.0","1.0","2.0","1.0","1.0"
"ranchi","jharkhand","Rakadih","364.0","374238.0",98,47,51,56,34,22,22,19,3,"6","2","2","1","1","5.0","1.0","2.0","1.0","1.0"
"ranchi","jharkhand","Chatwal","364.0","374239.0",2447,1246,1201,1643,865,778,862,636,226,"8","2","2","1","3","6.0","1.0","3.0","1.0","1.0"
"ranchi","jharkhand","Pakaria","364.0","374240.0",2452,1207,1245,1487,792,695,1003,560,443,"6","2","2","1","1","5.0","1.0","2.0","1.0","1.0"
"ranchi","jharkhand","Masmano","364.0","374241.0",2108,1026,1082,1272,701,571,1123,582,541,"6","2","2","1","1","5.0","1.0","2.0","1.0","1.0"
"ranchi","jharkhand","Karambo","364.0","374242.0",208,106,102,113,66,47,159,84,75,"4","1","1","1","1","5.0","1.0","2.0","1.0","1.0"
"ranchi","jharkhand","Tala","364.0","374243.0",2186,1116,1070,1198,712,486,1051,547,504,"6","2","2","1","1","5.0","1.0","2.0","1.0","1.0"
"ranchi","jharkhand","Kamta","364.0","374244.0",2401,1195,1206,1198,666,532,1316,674,642,"5","2","1","1","1","5.0","1.0","2.0","1.0","1.0"
"ranchi","jharkhand","Chaliyo","364.0","374246.0",2136,1084,1052,949,552,397,995,512,483,"4","1","1","1","1","5.0","1.0","2.0","1.0","1.0"
"ranchi","jharkhand","Taranga","364.0","374247.0",2722,1379,1343,1365,794,571,1121,691,430,"5","2","1","1","1","6.0","1.0","3.0","1.0","1.0"
"ranchi","jharkhand","Soparam","364.0","374248.0",2090,1102,988,1020,626,394,983,562,421,"4","1","1","1","1","6.0","1.0","3.0","1.0","1.0"
"ranchi","jharkhand","Lepsar","364.0","374249.0",892,476,416,532,347,185,525,261,264,"7","2","3","1","1","5.0","1.0","2.0","1.0","1.0"
"ranchi","jharkhand","Harra","364.0","374250.0",899,451,448,472,277,195,393,230,163,"4","1","1","1","1","5.0","1.0","2.0","1.0","1.0"
"ranchi","jharkhand","Madhukam","364.0","374251.0",894,441,453,450,263,187,539,270,269,"5","2","1","1","1","5.0","1.0","2.0","1.0","1.0"
"ranchi","jharkhand","Nunhu","364.0","374252.0",667,345,322,265,167,98,265,145,120,"4","1","1","1","1","5.0","1.0","2.0","1.0","1.0"
"ranchi","jharkhand","Choreya","364.0","374253.0",4994,2556,2438,3293,1881,1412,2038,1369,669,"5","1","2","1","1","8.0","1.0","3.0","3.0","1.0"
"ranchi","jharkhand","Gutua","364.0","374256.0",924,453,471,525,292,233,470,234,236,"6","2","2","1","1","5.0","1.0","2.0","1.0","1.0"
"ranchi","jharkhand","Karkat","364.0","374257.0",3835,1903,1932,2031,1178,853,1542,941,601,"6","2","2","1","1","5.0","1.0","2.0","1.0","1.0"
"ranchi","jharkhand","Rol (Rola)","364.0","374258.0",2489,1246,1243,1282,768,514,1211,625,586,"4","1","1","1","1","6.0","3.0","1.0","1.0","1.0"
"ranchi","jharkhand","Tangar","364.0","374259.0",3058,1563,1495,1853,1028,825,1235,768,467,"5","1","2","1","1","5.0","1.0","2.0","1.0","1.0"
"ranchi","jharkhand","Kataiya","364.0","374260.0",170,87,83,70,33,37,63,35,28,"7","2","2","2","1","4.0","1.0","1.0","1.0","1.0"
"ranchi","jharkhand","Koko","364.0","374262.0",1071,540,531,590,314,276,496,280,216,"5","1","2","1","1","5.0","1.0","2.0","1.0","1.0"
"ranchi","jharkhand","Lundri","364.0","374263.0",3935,1970,1965,2135,1215,920,2037,1038,999,"4","1","1","1","1","6.0","2.0","2.0","1.0","1.0"
"ranchi","jharkhand","Silagain","364.0","374264.0",2637,1337,1300,1339,775,564,1248,628,620,"6","1","2","2","1","5.0","1.0","2.0","1.0","1.0"
"ranchi","jharkhand","Melani","364.0","374265.0",962,482,480,468,275,193,564,281,283,"7","2","1","3","1","5.0","1.0","2.0","1.0","1.0"
"ranchi","jharkhand","Murto","364.0","374266.0",1477,731,746,780,457,323,534,356,178,"5","2","1","1","1","4.0","1.0","1.0","1.0","1.0"
"ranchi","jharkhand","Hondpiri","364.0","374267.0",590,300,290,335,213,122,256,112,144,"5","2","1","1","1","6.0","2.0","2.0","1.0","1.0"
"ranchi","jharkhand","Kullu","364.0","374268.0",1043,528,515,538,322,216,550,285,265,"4","1","1","1","1","6.0","2.0","2.0","1.0","1.0"
"ranchi","jharkhand","Kanjgi","364.0","374269.0",841,436,405,391,238,153,405,222,183,"4","1","1","1","1","5.0","1.0","2.0","1.0","1.0"
"ranchi","jharkhand","Beyasi","364.0","374270.0",1805,941,864,1144,664,480,483,395,88,"5","2","1","1","1","5.0","1.0","2.0","1.0","1.0"
"ranchi","jharkhand","Madai","364.0","374271.0",731,371,360,360,233,127,175,172,3,"5","1","1","2","1","5.0","1.0","2.0","1.0","1.0"
"ranchi","jharkhand","Goke","364.0","374272.0",938,480,458,615,353,262,350,212,138,"7","2","1","3","1","5.0","1.0","2.0","1.0","1.0"
"ranchi","jharkhand","Chutyo","364.0","374273.0",481,233,248,252,152,100,204,92,112,"6","1","2","2","1","5.0","1.0","2.0","1.0","1.0"
"ranchi","jharkhand","Naudi","364.0","374275.0",986,478,508,616,340,276,344,210,134,"8","1","2","2","3","5.0","1.0","2.0","1.0","1.0"
"ranchi","jharkhand","Barkakura","364.0","374421.0",1072,510,562,554,314,240,539,281,258,"4","1","1","1","1","5.0","1.0","2.0","1.0","1.0"
"ranchi","jharkhand","Gudgud","364.0","374422.0",318,162,156,174,103,71,157,92,65,"6","2","2","1","1","5.0","1.0","2.0","1.0","1.0"
"ranchi","jharkhand","Tapkara","364.0","374423.0",322,157,165,184,106,78,206,98,108,"4","1","1","1","1","5.0","1.0","2.0","1.0","1.0"
"ranchi","jharkhand","Tangarkela","364.0","374424.0",515,251,264,301,165,136,252,123,129,"6","2","2","1","1","5.0","1.0","2.0","1.0","1.0"
"ranchi","jharkhand","Burhni","364.0","374425.0",440,208,232,329,168,161,248,122,126,"4","1","1","1","1","5.0","1.0","2.0","1.0","1.0"
"ranchi","jharkhand","Mahugaon","364.0","374426.0",1359,640,719,839,448,391,716,361,355,"6","2","2","1","1","5.0","1.0","2.0","1.0","1.0"
"ranchi","jharkhand","Jariya","364.0","374427.0",826,430,396,442,257,185,513,260,253,"4","1","1","1","1","5.0","1.0","2.0","1.0","1.0"
"ranchi","jharkhand","Kathkunwari","364.0","374428.0",869,434,435,460,267,193,533,263,270,"4","1","1","1","1","5.0","1.0","2.0","1.0","1.0"
"ranchi","jharkhand","Jamakel","364.0","374429.0",564,284,280,340,183,157,341,184,157,"5","2","1","1","1","5.0","1.0","2.0","1.0","1.0"
"ranchi","jharkhand","Hulsu","364.0","374430.0",2017,1049,968,1295,747,548,1115,584,531,"5","2","1","1","1","5.0","1.0","2.0","1.0","1.0"
"ranchi","jharkhand","Chalangi","364.0","374431.0",1025,513,512,585,333,252,711,350,361,"4","1","1","1","1","6.0","1.0","3.0","1.0","1.0"
"ranchi","jharkhand","Ulgara","364.0","374432.0",210,96,114,128,69,59,122,55,67,"4","1","1","1","1","5.0","1.0","2.0","1.0","1.0"
"ranchi","jharkhand","Kalje","364.0","374433.0",241,110,131,100,54,46,135,68,67,"4","1","1","1","1","5.0","1.0","2.0","1.0","1.0"
"ranchi","jharkhand","Chanpi","364.0","374434.0",186,99,87,115,69,46,108,54,54,"5","2","1","1","1","5.0","1.0","2.0","1.0","1.0"
"ranchi","jharkhand","Bankakera","364.0","374435.0",656,332,324,370,209,161,381,190,191,"6","2","2","1","1","5.0","1.0","2.0","1.0","1.0"
"ranchi","jharkhand","Orekel","364.0","374436.0",666,335,331,261,147,114,342,159,183,"4","1","1","1","1","5.0","1.0","2.0","1.0","1.0"
"ranchi","jharkhand","Chalha","364.0","374437.0",230,117,113,126,82,44,122,66,56,"6","2","2","1","1","5.0","1.0","2.0","1.0","1.0"
"ranchi","jharkhand","Baragain","364.0","374438.0",307,131,176,135,74,61,214,94,120,"5","2","1","1","1","5.0","1.0","2.0","1.0","1.0"
"ranchi","jharkhand","Garai","364.0","374439.0",906,434,472,490,273,217,615,297,318,"4","1","1","1","1","5.0","1.0","2.0","1.0","1.0"
"ranchi","jharkhand","Fatehpur","364.0","374440.0",1126,552,574,573,315,258,748,356,392,"4","1","1","1","1","5.0","1.0","2.0","1.0","1.0"
"ranchi","jharkhand","Murup","364.0","374441.0",300,163,137,153,98,55,184,100,84,"5","2","1","1","1","5.0","1.0","2.0","1.0","1.0"
"ranchi","jharkhand","Dari","364.0","374442.0",2035,996,1039,1026,573,453,754,494,260,"4","1","1","1","1","5.0","1.0","2.0","1.0","1.0"
"ranchi","jharkhand","Malgo","364.0","374443.0",2248,1109,1139,1068,622,446,886,541,345,"5","1","2","1","1","5.0","1.0","2.0","1.0","1.0"
"ranchi","jharkhand","Jhiki","364.0","374444.0",427,219,208,200,130,70,247,132,115,"5","2","1","1","1","5.0","1.0","2.0","1.0","1.0"
"ranchi","jharkhand","Manri","364.0","374445.0",1032,516,516,359,234,125,517,249,268,"4","1","1","1","1","6.0","1.0","3.0","1.0","1.0"
"ranchi","jharkhand","Unekel","364.0","374447.0",443,220,223,207,119,88,104,90,14,"4","1","1","1","1","5.0","1.0","2.0","1.0","1.0"
"ranchi","jharkhand","Koisara","364.0","374448.0",831,401,430,412,231,181,308,180,128,"5","2","1","1","1","5.0","1.0","2.0","1.0","1.0"
"ranchi","jharkhand","Semla","364.0","374449.0",808,409,399,414,240,174,455,232,223,"5","2","1","1","1","5.0","1.0","2.0","1.0","1.0"
"ranchi","jharkhand","Duru","364.0","374450.0",606,315,291,316,189,127,292,142,150,"4","1","1","1","1","5.0","1.0","2.0","1.0","1.0"
"ranchi","jharkhand","Pola","364.0","374451.0",736,359,377,327,190,137,364,182,182,"4","1","1","1","1","4.0","1.0","1.0","1.0","1.0"
"ranchi","jharkhand","Tilai","364.0","374452.0",408,198,210,163,96,67,210,107,103,"5","2","1","1","1","5.0","1.0","2.0","1.0","1.0"
"ranchi","jharkhand","Sakarpur","364.0","374453.0",1076,521,555,478,278,200,461,262,199,"4","1","1","1","1","5.0","1.0","2.0","1.0","1.0"
"ranchi","jharkhand","Dewgaon","364.0","374454.0",1249,615,634,496,294,202,687,355,332,"5","1","2","1","1","5.0","1.0","2.0","1.0","1.0"
"ranchi","jharkhand","Sarsa","364.0","374455.0",1163,573,590,475,285,190,644,326,318,"4","1","1","1","1","4.0","1.0","1.0","1.0","1.0"
"ranchi","jharkhand","Taberkhurd","364.0","374456.0",397,210,187,185,112,73,268,144,124,"4","1","1","1","1","6.0","3.0","1.0","1.0","1.0"
"ranchi","jharkhand","Seheda","364.0","374457.0",480,248,232,258,164,94,270,145,125,"4","1","1","1","1","6.0","2.0","1.0","1.0","2.0"
"ranchi","jharkhand","Latratu","364.0","374459.0",1175,596,579,411,263,148,571,285,286,"4","1","1","1","1","5.0","1.0","2.0","1.0","1.0"
"ranchi","jharkhand","Balandu","364.0","374460.0",1008,500,508,432,252,180,491,246,245,"4","1","1","1","1","5.0","1.0","2.0","1.0","1.0"
"ranchi","jharkhand","Nawatoli","364.0","374461.0",698,348,350,374,215,159,388,194,194,"5","1","2","1","1","5.0","1.0","2.0","1.0","1.0"
"ranchi","jharkhand","Tigra","364.0","374464.0",375,182,193,220,124,96,181,91,90,"5","1","2","1","1","6.0","2.0","2.0","1.0","1.0"
"ranchi","jharkhand","Tetra","364.0","374465.0",618,320,298,303,179,124,288,160,128,"4","1","1","1","1","5.0","1.0","2.0","1.0","1.0"
"ranchi","jharkhand","Khatanga","364.0","374466.0",1006,505,501,515,300,215,508,251,257,"4","1","1","1","1","5.0","1.0","2.0","1.0","1.0"
"ranchi","jharkhand","Takriya","364.0","374467.0",1260,672,588,844,513,331,460,343,117,"6","2","2","1","1","5.0","1.0","2.0","1.0","1.0"
"ranchi","jharkhand","Kurkuriya","364.0","374468.0",474,228,246,287,156,131,209,103,106,"4","1","1","1","1","6.0","1.0","3.0","1.0","1.0"
"ranchi","jharkhand","Kandarkel","364.0","374469.0",351,172,179,165,95,70,113,64,49,"5","2","1","1","1","6.0","1.0","3.0","1.0","1.0"
"ranchi","jharkhand","Champadih","364.0","374470.0",770,413,357,368,234,134,374,188,186,"5","2","1","1","1","5.0","1.0","2.0","1.0","1.0"
"ranchi","jharkhand","Karum","364.0","374471.0",584,301,283,295,179,116,310,157,153,"4","1","1","1","1","5.0","1.0","2.0","1.0","1.0"
"ranchi","jharkhand","Pokta","364.0","374472.0",1302,648,654,581,347,234,502,294,208,"4","1","1","1","1","5.0","1.0","2.0","1.0","1.0"
"ranchi","jharkhand","Akumroma","364.0","374473.0",800,394,406,406,239,167,439,223,216,"4","1","1","1","1","5.0","1.0","2.0","1.0","1.0"
"ranchi","jharkhand","Sumandih","364.0","374474.0",1330,692,638,891,538,353,698,342,356,"4","1","1","1","1","6.0","2.0","2.0","1.0","1.0"
"ranchi","jharkhand","Erkia","364.0","374475.0",820,416,404,545,321,224,564,287,277,"5","1","2","1","1","6.0","2.0","2.0","1.0","1.0"
"ranchi","jharkhand","Sutilong","364.0","374476.0",740,359,381,416,255,161,413,195,218,"4","1","1","1","1","5.0","1.0","2.0","1.0","1.0"
"ranchi","jharkhand","Hethburhadih","364.0","374477.0",441,220,221,295,185,110,243,122,121,"5","1","1","2","1","5.0","1.0","2.0","1.0","1.0"
"ranchi","jharkhand","Burhadih","364.0","374478.0",764,365,399,330,219,111,459,222,237,"5","2","1","1","1","5.0","1.0","2.0","1.0","1.0"
"ranchi","jharkhand","Bichahatu","364.0","374479.0",674,327,347,362,219,143,418,198,220,"6","1","1","3","1","6.0","2.0","2.0","1.0","1.0"
"ranchi","jharkhand","Paramdih","364.0","374480.0",664,328,336,451,261,190,383,199,184,"5","1","2","1","1","7.0","1.0","2.0","3.0","1.0"
"ranchi","jharkhand","Baghadih","364.0","374481.0",776,399,377,478,299,179,420,213,207,"5","2","1","1","1","5.0","1.0","2.0","1.0","1.0"
"ranchi","jharkhand","Burudih","364.0","374482.0",317,172,145,186,119,67,182,94,88,"4","1","1","1","1","5.0","1.0","2.0","1.0","1.0"
"ranchi","jharkhand","Sirkadih","364.0","374483.0",768,401,367,541,336,205,445,218,227,"5","2","1","1","1","5.0","1.0","2.0","1.0","1.0"
"ranchi","jharkhand","Lepadih","364.0","374484.0",50,25,25,36,22,14,26,13,13,"5","2","1","1","1","5.0","1.0","2.0","1.0","1.0"
"ranchi","jharkhand","Kanchi","364.0","374485.0",2610,1337,1273,1485,913,572,1188,693,495,"5","2","1","1","1","5.0","1.0","2.0","1.0","1.0"
"ranchi","jharkhand","Gosanidih","364.0","374486.0",769,381,388,448,267,181,456,231,225,"6","2","2","1","1","5.0","1.0","2.0","1.0","1.0"
"ranchi","jharkhand","Gutuhatu","364.0","374487.0",1224,637,587,651,444,207,371,321,50,"4","1","1","1","1","5.0","1.0","2.0","1.0","1.0"
"ranchi","jharkhand","Bhabhri","364.0","374488.0",210,113,97,111,69,42,110,55,55,"6","3","1","1","1","5.0","1.0","2.0","1.0","1.0"
"ranchi","jharkhand","Damari","364.0","374489.0",1436,748,688,751,453,298,496,361,135,"5","1","2","1","1","5.0","1.0","2.0","1.0","1.0"
"ranchi","jharkhand","Neuri","364.0","374491.0",129,60,69,58,31,27,43,33,10,"6","3","1","1","1","5.0","1.0","2.0","1.0","1.0"
"ranchi","jharkhand","Alna","364.0","374492.0",417,216,201,259,166,93,178,116,62,"6","3","1","1","1","5.0","1.0","2.0","1.0","1.0"
"ranchi","jharkhand","Dalkidih","364.0","374493.0",1250,637,613,786,477,309,328,304,24,"5","1","2","1","1","5.0","1.0","2.0","1.0","1.0"
"ranchi","jharkhand","Chitodih","364.0","374494.0",597,297,300,364,214,150,295,160,135,"7","3","2","1","1","5.0","1.0","2.0","1.0","1.0"
"ranchi","jharkhand","Tilaimarcha","364.0","374495.0",423,227,196,251,166,85,117,111,6,"5","2","1","1","1","8.0","2.0","2.0","3.0","1.0"
"ranchi","jharkhand","Khudimadkam","364.0","374496.0",813,433,380,503,320,183,436,237,199,"4","1","1","1","1","5.0","1.0","2.0","1.0","1.0"
"ranchi","jharkhand","Reladih","364.0","374497.0",1954,992,962,1192,682,510,831,520,311,"5","2","1","1","1","5.0","1.0","2.0","1.0","1.0"
"ranchi","jharkhand","Bhorangadih","364.0","374498.0",432,204,228,218,123,95,174,104,70,"5","2","1","1","1","5.0","1.0","2.0","1.0","1.0"
"ranchi","jharkhand","Bahadih","364.0","374499.0",287,141,146,144,81,63,94,71,23,"5","1","2","1","1","5.0","1.0","2.0","1.0","1.0"
"ranchi","jharkhand","Amjora","364.0","374501.0",772,401,371,404,256,148,427,226,201,"5","2","1","1","1","5.0","1.0","2.0","1.0","1.0"
"ranchi","jharkhand","Tunju","364.0","374503.0",2250,1115,1135,1271,711,560,1016,582,434,"5","2","1","1","1","5.0","1.0","2.0","1.0","1.0"
"ranchi","jharkhand","Pangura","364.0","374504.0",352,182,170,233,141,92,209,113,96,"4","1","1","1","1","6.0","2.0","2.0","1.0","1.0"
"ranchi","jharkhand","Baredih","364.0","374505.0",1262,664,598,708,436,272,506,339,167,"4","1","1","1","1","5.0","1.0","2.0","1.0","1.0"
"ranchi","jharkhand","Karambu","364.0","374506.0",1219,631,588,639,415,224,418,318,100,"4","1","1","1","1","6.0","2.0","2.0","1.0","1.0"
"ranchi","jharkhand","Anredih","364.0","374507.0",290,157,133,183,111,72,95,79,16,"4","1","1","1","1","4.0","1.0","1.0","1.0","1.0"
"ranchi","jharkhand","Karkadih","364.0","374508.0",33,15,18,19,11,8,10,8,2,"5","2","1","1","1","5.0","1.0","2.0","1.0","1.0"
"ranchi","jharkhand","Baruhatu","364.0","374509.0",1791,908,883,954,594,360,772,535,237,"5","2","1","1","1","5.0","1.0","2.0","1.0","1.0"
"ranchi","jharkhand","Huanghatu","364.0","374510.0",357,178,179,191,122,69,216,104,112,"4","1","1","1","1","5.0","1.0","2.0","1.0","1.0"
"ranchi","jharkhand","Daruhatu","364.0","374511.0",312,154,158,194,112,82,196,95,101,"5","2","1","1","1","4.0","1.0","1.0","1.0","1.0"
"ranchi","jharkhand","Sarjamdih","364.0","374513.0",483,259,224,311,202,109,397,219,178,"4","1","1","1","1","7.0","3.0","2.0","1.0","1.0"
"ranchi","jharkhand","Loahatu","364.0","374514.0",649,314,335,341,204,137,288,142,146,"4","1","1","1","1","5.0","1.0","2.0","1.0","1.0"
"ranchi","jharkhand","Churgi","364.0","374515.0",962,482,480,432,255,177,637,315,322,"4","1","1","1","1","5.0","1.0","2.0","1.0","1.0"
"ranchi","jharkhand","Pansakam","364.0","374516.0",584,302,282,317,193,124,440,228,212,"4","1","1","1","1","6.0","3.0","1.0","1.0","1.0"
"ranchi","jharkhand","Bera","364.0","374517.0",369,187,182,222,134,88,219,105,114,"4","1","1","1","1","6.0","2.0","2.0","1.0","1.0"
"ranchi","jharkhand","Hanjed","364.0","374518.0",798,392,406,439,271,168,433,212,221,"4","1","1","1","1","7.0","2.0","3.0","1.0","1.0"
"ranchi","jharkhand","Buchadih","364.0","374519.0",1071,568,503,567,375,192,460,278,182,"4","1","1","1","1","5.0","1.0","2.0","1.0","1.0"
"ranchi","jharkhand","Reda","364.0","374520.0",915,472,443,426,287,139,286,226,60,"4","1","1","1","1","5.0","1.0","2.0","1.0","1.0"
"ranchi","jharkhand","Tirildih","364.0","374521.0",641,331,310,386,232,154,350,177,173,"5","2","1","1","1","5.0","1.0","2.0","1.0","1.0"
"ranchi","jharkhand","Arradih","364.0","374522.0",832,413,419,337,213,124,475,231,244,"4","1","1","1","1","5.0","1.0","2.0","1.0","1.0"
"ranchi","jharkhand","Chutru","364.0","374523.0",197,107,90,79,56,23,111,52,59,"5","1","2","1","1","6.0","2.0","2.0","1.0","1.0"
"ranchi","jharkhand","Jojoda","364.0","374524.0",254,127,127,145,87,58,148,71,77,"5","1","2","1","1","8.0","2.0","2.0","1.0","3.0"
"ranchi","jharkhand","Edalhatu","364.0","374525.0",1936,989,947,1170,717,453,1026,543,483,"5","2","1","1","1","7.0","3.0","2.0","1.0","1.0"
"ranchi","jharkhand","Gowaidih","364.0","374526.0",362,183,179,216,128,88,206,99,107,"4","1","1","1","1","5.0","1.0","2.0","1.0","1.0"
"ranchi","jharkhand","Salgadih","364.0","374527.0",794,375,419,386,230,156,267,195,72,"6","3","1","1","1","5.0","1.0","2.0","1.0","1.0"
"ranchi","jharkhand","Barkolma","364.0","374529.0",665,335,330,343,204,139,192,162,30,"4","1","1","1","1","5.0","1.0","2.0","1.0","1.0"
"ranchi","jharkhand","Jamgami","364.0","374530.0",854,441,413,451,296,155,464,238,226,"4","1","1","1","1","5.0","1.0","2.0","1.0","1.0"
"ranchi","jharkhand","Lotehatu","364.0","374531.0",513,266,247,259,177,82,409,208,201,"5","1","2","1","1","6.0","2.0","2.0","1.0","1.0"
"ranchi","jharkhand","Madhukama","364.0","374532.0",629,329,300,394,248,146,394,190,204,"4","1","1","1","1","6.0","2.0","2.0","1.0","1.0"
"ranchi","jharkhand","Baruhatu","364.0","374533.0",620,303,317,344,207,137,332,160,172,"4","1","1","1","1","5.0","1.0","2.0","1.0","1.0"
"ranchi","jharkhand","Jareya","364.0","374534.0",694,342,352,368,221,147,393,194,199,"5","2","1","1","1","5.0","1.0","2.0","1.0","1.0"
"ranchi","jharkhand","Humta","364.0","374535.0",2456,1261,1195,1419,896,523,1257,680,577,"4","1","1","1","1","5.0","1.0","2.0","1.0","1.0"
"ranchi","jharkhand","Kajibaru","364.0","374536.0",286,150,136,186,115,71,175,89,86,"5","1","2","1","1","5.0","1.0","2.0","1.0","1.0"
"ranchi","jharkhand","Moisodih","364.0","374537.0",314,160,154,198,120,78,176,94,82,"4","1","1","1","1","6.0","2.0","2.0","1.0","1.0"
"ranchi","jharkhand","Ulida","364.0","374539.0",243,117,126,111,73,38,138,63,75,"5","2","1","1","1","5.0","1.0","2.0","1.0","1.0"
"ranchi","jharkhand","Kadrudih","364.0","374540.0",193,106,87,105,73,32,103,49,54,"5","2","1","1","1","7.0","3.0","2.0","1.0","1.0"
"ranchi","jharkhand","Haludih","364.0","374541.0",110,65,45,45,32,13,38,26,12,"4","1","1","1","1","6.0","2.0","2.0","1.0","1.0"
"ranchi","jharkhand","Kuchidih","364.0","374542.0",367,176,191,202,123,79,163,93,70,"4","1","1","1","1","6.0","2.0","2.0","1.0","1.0"
"ranchi","jharkhand","Roredih","364.0","374543.0",162,80,82,87,53,34,70,42,28,"4","1","1","1","1","9.0","2.0","3.0","3.0","1.0"
"ranchi","jharkhand","Bhurkunda","364.0","374544.0",133,60,73,77,40,37,75,36,39,"4","1","1","1","1","5.0","1.0","2.0","1.0","1.0"
"ranchi","jharkhand","Nawadih","364.0","374545.0",225,118,107,110,64,46,103,60,43,"4","1","1","1","1","6.0","2.0","2.0","1.0","1.0"
"ranchi","jharkhand","Singardih","364.0","374546.0",130,62,68,68,43,25,62,31,31,"5","2","1","1","1","6.0","2.0","2.0","1.0","1.0"
"ranchi","jharkhand","Besradih","364.0","374547.0",244,117,127,122,73,49,139,67,72,"4","1","1","1","1","5.0","1.0","2.0","1.0","1.0"
"ranchi","jharkhand","Gabhreya","364.0","374548.0",959,502,457,601,375,226,587,296,291,"4","1","1","1","1","5.0","1.0","2.0","1.0","1.0"
"ranchi","jharkhand","Ghaghrabera","364.0","374549.0",441,216,225,251,150,101,236,119,117,"4","1","1","1","1","5.0","1.0","2.0","1.0","1.0"
"ranchi","jharkhand","Nehalgara","364.0","374550.0",342,179,163,114,72,42,187,96,91,"5","2","1","1","1","5.0","1.0","2.0","1.0","1.0"
"ranchi","jharkhand","Hesapiri","364.0","374551.0",364,186,178,213,122,91,210,109,101,"5","2","1","1","1","6.0","2.0","2.0","1.0","1.0"
"ranchi","jharkhand","Taimara","364.0","374552.0",1416,738,678,889,553,336,593,421,172,"4","1","1","1","1","6.0","1.0","3.0","1.0","1.0"
"ranchi","jharkhand","Banaburu","364.0","374553.0",626,312,314,367,227,140,311,165,146,"4","1","1","1","1","5.0","1.0","2.0","1.0","1.0"
"ranchi","jharkhand","Korda","364.0","374554.0",854,399,455,426,259,167,267,219,48,"4","1","1","1","1","5.0","1.0","2.0","1.0","1.0"
"ranchi","jharkhand","Labga","364.0","374555.0",796,378,418,430,251,179,504,237,267,"4","1","1","1","1","6.0","2.0","2.0","1.0","1.0"
"ranchi","jharkhand","Husirhatu","364.0","374556.0",657,321,336,389,235,154,232,162,70,"5","1","2","1","1","6.0","2.0","2.0","1.0","1.0"
"ranchi","jharkhand","Kolanghatu","364.0","374558.0",465,246,219,246,155,91,149,131,18,"5","2","1","1","1","5.0","1.0","2.0","1.0","1.0"
"ranchi","jharkhand","Murgidih","364.0","374559.0",146,73,73,62,39,23,44,32,12,"5","2","1","1","1","5.0","1.0","2.0","1.0","1.0"
"ranchi","jharkhand","Dami","364.0","374560.0",794,393,401,357,231,126,453,217,236,"4","1","1","1","1","4.0","1.0","1.0","1.0","1.0"
"ranchi","jharkhand","Pancha","364.0","374561.0",648,316,332,313,193,120,345,160,185,"5","1","2","1","1","5.0","1.0","2.0","1.0","1.0"
"ranchi","jharkhand","Arahanga","364.0","374562.0",1411,710,701,514,337,177,871,433,438,"4","1","1","1","1","5.0","1.0","2.0","1.0","1.0"
"ranchi","jharkhand","Makramdih","364.0","374563.0",1083,540,543,655,380,275,565,284,281,"4","1","1","1","1","5.0","1.0","2.0","1.0","1.0"
"ranchi","jharkhand","Siram","364.0","373368.0",846,416,430,343,199,144,353,214,139,"4","1","1","1","1","6.0","1.0","3.0","1.0","1.0"
"ranchi","jharkhand","Ulatu","364.0","373369.0",599,317,282,353,227,126,326,167,159,"5","2","1","1","1","7.0","1.0","3.0","1.0","2.0"
"ranchi","jharkhand","Kedli","364.0","373370.0",924,470,454,491,292,199,441,234,207,"4","1","1","1","1","7.0","2.0","3.0","1.0","1.0"
"ranchi","jharkhand","Aktan","364.0","373371.0",748,383,365,439,277,162,251,164,87,"6","1","1","1","3","6.0","1.0","3.0","1.0","1.0"
"ranchi","jharkhand","Sumu","364.0","373372.0",1521,776,745,715,435,280,575,372,203,"7","2","1","1","3","5.0","1.0","2.0","1.0","1.0"
"ranchi","jharkhand","Kander","364.0","373373.0",796,421,375,347,203,144,286,227,59,"5","1","2","1","1","6.0","1.0","3.0","1.0","1.0"
"ranchi","jharkhand","Koejam","364.0","373374.0",525,283,242,316,203,113,134,118,16,"4","1","1","1","1","5.0","1.0","2.0","1.0","1.0"
"ranchi","jharkhand","Arid","364.0","373375.0",718,336,382,367,207,160,356,172,184,"4","1","1","1","1","5.0","1.0","2.0","1.0","1.0"
"ranchi","jharkhand","Hendag","364.0","373376.0",349,187,162,207,132,75,188,94,94,"4","1","1","1","1","5.0","1.0","2.0","1.0","1.0"
"ranchi","jharkhand","Churugara","364.0","373377.0",419,221,198,202,130,72,251,128,123,"4","1","1","1","1","5.0","1.0","2.0","1.0","1.0"
"ranchi","jharkhand","Chapra","364.0","373378.0",1840,951,889,1020,629,391,951,505,446,"6","1","2","2","1","6.0","1.0","3.0","1.0","1.0"
"ranchi","jharkhand","Binja","364.0","373379.0",2284,1161,1123,1030,596,434,1252,633,619,"4","1","1","1","1","5.0","1.0","2.0","1.0","1.0"
"ranchi","jharkhand","Hering","364.0","373380.0",262,120,142,109,65,44,121,63,58,"4","1","1","1","1","5.0","1.0","2.0","1.0","1.0"
"ranchi","jharkhand","Chaingara","364.0","373381.0",1686,842,844,970,570,400,841,424,417,"4","1","1","1","1","6.0","1.0","3.0","1.0","1.0"
"ranchi","jharkhand","Salhan","364.0","373382.0",553,274,279,314,183,131,239,119,120,"5","2","1","1","1","5.0","1.0","2.0","1.0","1.0"
"ranchi","jharkhand","Kori","364.0","373383.0",392,202,190,205,119,86,203,109,94,"4","1","1","1","1","5.0","1.0","2.0","1.0","1.0"
"ranchi","jharkhand","Lawagara","364.0","373384.0",337,180,157,208,131,77,97,70,27,"4","1","1","1","1","6.0","1.0","3.0","1.0","1.0"
"ranchi","jharkhand","Anatu","364.0","373385.0",693,336,357,433,248,185,358,183,175,"4","1","1","1","1","6.0","1.0","3.0","1.0","1.0"
"ranchi","jharkhand","Chalniya (Chalaniya)","364.0","373386.0",318,144,174,136,80,56,122,69,53,"6","1","1","1","3","6.0","1.0","3.0","1.0","1.0"
"ranchi","jharkhand","Erud","364.0","373387.0",164,83,81,63,33,30,80,44,36,"4","1","1","1","1","5.0","1.0","2.0","1.0","1.0"
"ranchi","jharkhand","Umedanda","364.0","373388.0",3644,1886,1758,2270,1341,929,1643,961,682,"4","1","1","1","1","6.0","1.0","3.0","1.0","1.0"
"ranchi","jharkhand","Barkamuru","364.0","373389.0",1003,522,481,585,356,229,394,265,129,"7","1","2","1","3","5.0","1.0","2.0","1.0","1.0"
"ranchi","jharkhand","Sosai","364.0","373390.0",1589,820,769,855,532,323,782,493,289,"5","1","2","1","1","6.0","1.0","3.0","1.0","1.0"
"ranchi","jharkhand","Ichapiri","364.0","373391.0",1377,697,680,648,365,283,726,387,339,"4","1","1","1","1","5.0","1.0","2.0","1.0","1.0"
"ranchi","jharkhand","Hutpai","364.0","373392.0",157,84,73,102,66,36,90,43,47,"5","1","2","1","1","6.0","1.0","3.0","1.0","1.0"
"ranchi","jharkhand","Makka","364.0","373393.0",2188,1134,1054,1166,687,479,1231,636,595,"4","1","1","1","1","5.0","1.0","2.0","1.0","1.0"
"ranchi","jharkhand","Kanadih","364.0","373394.0",753,387,366,375,228,147,322,172,150,"4","1","1","1","1","5.0","1.0","2.0","1.0","1.0"
"ranchi","jharkhand","Karamba","364.0","373396.0",660,340,320,207,136,71,317,160,157,"4","1","1","1","1","6.0","1.0","3.0","1.0","1.0"
"ranchi","jharkhand","Ojhasaram","364.0","373398.0",1542,772,770,817,490,327,743,378,365,"4","1","1","1","1","5.0","1.0","2.0","1.0","1.0"
"ranchi","jharkhand","Lothmana","364.0","373399.0",462,220,242,226,130,96,176,89,87,"4","1","1","1","1","7.0","2.0","3.0","1.0","1.0"
"ranchi","jharkhand","Ara","364.0","373400.0",779,402,377,283,159,124,412,208,204,"4","1","1","1","1","6.0","1.0","3.0","1.0","1.0"
